sno,TP12,TP1,TP2,TP1C,CL1,BY1,,,
0001.HK,3,0,0,0,7,0,10,30.00%,
0002.HK,1,0,3,1,4,0,9,44.44%,
0003.HK,1,1,0,0,3,3,8,25.00%,
0004.HK,6,0,2,1,5,1,15,53.33%,
0005.HK,2,1,0,2,7,0,12,25.00%,
0006.HK,0,1,1,0,1,0,3,66.67%,
0008.HK,2,0,1,0,3,1,7,42.86%,
0011.HK,5,0,0,0,1,0,6,83.33%,
0012.HK,5,1,0,2,5,2,15,40.00%,
0016.HK,3,1,0,0,5,0,9,44.44%,
0019.HK,3,4,0,1,3,0,11,63.64%,
0020.HK,0,0,0,0,2,0,2,0.00%,
0023.HK,4,1,1,0,5,1,12,50.00%,
0027.HK,4,0,0,1,4,2,11,36.36%,
0066.HK,3,0,0,1,4,1,9,33.33%,
0083.HK,3,0,0,0,5,0,8,37.50%,
0087.HK,6,1,0,0,7,0,14,50.00%,
0101.HK,0,2,0,0,5,0,7,28.57%,
0135.HK,6,0,0,0,1,0,7,85.71%,
0136.HK,1,0,0,0,2,1,4,25.00%,
0144.HK,7,0,0,4,3,0,14,50.00%,
0148.HK,4,1,0,0,8,1,14,35.71%,
0151.HK,3,1,1,1,1,0,7,71.43%,
0168.HK,4,0,1,1,3,3,12,41.67%,
0175.HK,1,0,0,0,2,1,4,25.00%,
0179.HK,4,1,0,5,6,0,16,31.25%,
0220.HK,0,0,0,0,3,0,3,0.00%,
0241.HK,1,0,0,0,6,2,9,11.11%,
0247.HK,1,0,0,0,0,0,1,100.00%,
0267.HK,5,0,0,2,7,0,14,35.71%,
0268.HK,2,1,0,0,2,0,5,60.00%,
0270.HK,3,2,1,0,2,0,8,75.00%,
0285.HK,4,0,0,1,2,1,8,50.00%,
0288.HK,2,0,0,0,0,0,2,100.00%,
0291.HK,1,2,1,0,2,0,6,66.67%,
0293.HK,3,0,1,1,3,1,9,44.44%,
0300.HK,0,0,1,0,0,0,1,100.00%,
0316.HK,2,1,0,0,2,0,5,60.00%,
0322.HK,2,0,1,2,3,2,10,30.00%,
0358.HK,5,0,0,0,3,1,9,55.56%,
0384.HK,0,0,0,1,2,1,4,0.00%,
0386.HK,2,0,0,0,7,1,10,20.00%,
0388.HK,1,0,0,0,4,0,5,20.00%,
0392.HK,4,0,0,2,4,1,11,36.36%,
0425.HK,1,2,0,1,1,0,5,60.00%,
0486.HK,3,0,0,0,2,0,5,60.00%,
0522.HK,5,0,0,1,4,0,10,50.00%,
0656.HK,2,0,0,0,4,1,7,28.57%,
0659.HK,1,0,0,0,2,4,7,14.29%,
0669.HK,4,1,0,0,3,0,8,62.50%,
0700.HK,3,0,0,1,0,0,4,75.00%,
0728.HK,2,1,0,1,2,1,7,42.86%,
0753.HK,3,0,2,1,0,0,6,83.33%,
0762.HK,2,0,2,0,5,0,9,44.44%,
0763.HK,1,1,0,0,1,2,5,40.00%,
0772.HK,0,0,0,0,5,1,6,0.00%,
0788.HK,1,0,0,0,4,0,5,20.00%,
0836.HK,2,1,0,0,5,0,8,37.50%,
0857.HK,2,0,0,1,2,0,5,40.00%,
0867.HK,0,0,0,0,3,0,3,0.00%,
0868.HK,1,0,1,0,1,1,4,50.00%,
0881.HK,0,0,0,1,5,0,6,0.00%,
0883.HK,2,0,0,0,3,0,5,40.00%,
0914.HK,3,0,0,0,4,2,9,33.33%,
0939.HK,6,1,0,0,4,0,11,63.64%,
0941.HK,2,1,0,0,2,0,5,60.00%,
0945.HK,1,1,0,1,7,0,10,20.00%,
0966.HK,6,0,0,1,4,0,11,54.55%,
0968.HK,0,2,0,1,1,0,4,50.00%,
0981.HK,3,0,0,1,3,1,8,37.50%,
0992.HK,3,1,0,0,2,0,6,66.67%,
0998.HK,2,1,0,0,1,0,4,75.00%,
1024.HK,1,0,0,0,0,0,1,100.00%,
1038.HK,3,2,0,0,2,1,8,62.50%,
1044.HK,2,2,0,0,4,0,8,50.00%,
1088.HK,3,1,0,0,9,1,14,28.57%,
1093.HK,1,0,0,0,6,0,7,14.29%,
1128.HK,2,0,0,0,2,1,5,40.00%,
1142.HK,1,0,0,1,1,0,3,33.33%,
1171.HK,6,0,0,2,9,0,17,35.29%,
1177.HK,3,0,1,0,2,0,6,66.67%,
1179.HK,1,0,0,0,1,0,2,50.00%,
1193.HK,4,2,0,2,6,0,14,42.86%,
1208.HK,1,0,1,2,1,0,5,40.00%,
1209.HK,0,1,0,0,0,0,1,100.00%,
1211.HK,2,0,0,0,5,0,7,28.57%,
1258.HK,2,0,0,0,2,0,4,50.00%,
1288.HK,2,0,1,1,3,0,7,42.86%,
1299.HK,1,0,0,0,1,0,2,50.00%,
1308.HK,2,1,0,1,2,0,6,50.00%,
1336.HK,0,1,0,0,1,1,3,33.33%,
1339.HK,2,0,0,1,1,1,5,40.00%,
1347.HK,4,0,0,0,4,1,9,44.44%,
1357.HK,1,0,0,0,2,1,4,25.00%,
1378.HK,1,0,0,0,1,0,2,50.00%,
1398.HK,5,1,0,1,4,0,11,54.55%,
1519.HK,0,0,0,1,0,1,2,0.00%,
1530.HK,1,0,0,0,2,0,3,33.33%,
1548.HK,1,0,0,0,2,3,6,16.67%,
1585.HK,1,0,0,0,1,1,3,33.33%,
1658.HK,2,0,1,1,3,0,7,42.86%,
1729.HK,1,0,0,0,0,1,2,50.00%,
1735.HK,3,1,0,1,1,0,6,66.67%,
1776.HK,2,0,0,0,2,0,4,50.00%,
1787.HK,2,0,0,1,2,0,5,40.00%,
1788.HK,0,1,0,0,2,0,3,33.33%,
1801.HK,3,0,0,0,1,1,5,60.00%,
1810.HK,0,0,0,1,1,0,2,0.00%,
1816.HK,2,0,0,1,2,1,6,33.33%,
1818.HK,2,0,0,1,3,0,6,33.33%,
1833.HK,1,0,0,2,1,0,4,25.00%,
1876.HK,1,1,0,0,2,0,4,50.00%,
1882.HK,4,0,0,2,5,1,12,33.33%,
1888.HK,1,1,0,1,1,2,6,33.33%,
1898.HK,4,0,0,0,4,1,9,44.44%,
1913.HK,2,0,0,1,2,0,5,40.00%,
1919.HK,2,0,0,0,2,2,6,33.33%,
1928.HK,1,0,0,0,2,0,3,33.33%,
1929.HK,2,0,0,0,2,1,5,40.00%,
1988.HK,2,1,0,0,2,0,5,60.00%,
2015.HK,0,0,0,0,1,0,1,0.00%,
2018.HK,0,0,0,0,4,1,5,0.00%,
2020.HK,4,0,0,0,2,0,6,66.67%,
2057.HK,0,1,0,1,0,0,2,50.00%,
2076.HK,0,0,0,0,1,1,2,0.00%,
2096.HK,0,0,0,0,1,1,2,0.00%,
2099.HK,3,0,0,0,4,0,7,42.86%,
2269.HK,1,0,0,0,1,0,2,50.00%,
2282.HK,0,0,3,0,2,0,5,60.00%,
2318.HK,1,0,0,0,0,0,1,100.00%,
2319.HK,4,1,0,2,3,1,11,45.45%,
2328.HK,2,0,1,1,4,0,8,37.50%,
2331.HK,1,0,0,0,7,0,8,12.50%,
2333.HK,2,0,0,0,2,1,5,40.00%,
2359.HK,0,0,0,0,1,1,2,0.00%,
2367.HK,0,0,0,1,1,0,2,0.00%,
2378.HK,1,0,1,0,7,0,9,22.22%,
2380.HK,4,0,0,0,1,0,5,80.00%,
2382.HK,1,0,0,0,4,0,5,20.00%,
2388.HK,5,0,0,0,1,0,6,83.33%,
2400.HK,0,0,0,0,0,1,1,0.00%,
2588.HK,2,0,0,0,0,0,2,100.00%,
2600.HK,5,0,0,0,5,0,10,50.00%,
2601.HK,0,0,0,2,2,0,4,0.00%,
2618.HK,0,0,0,0,3,0,3,0.00%,
2628.HK,4,0,0,0,1,0,5,80.00%,
2638.HK,0,0,0,0,4,0,4,0.00%,
2688.HK,3,0,0,0,0,1,4,75.00%,
2799.HK,2,0,0,0,0,0,2,100.00%,
2888.HK,2,0,0,0,5,1,8,25.00%,
2899.HK,2,0,0,0,2,1,5,40.00%,
3328.HK,4,0,0,1,5,1,11,36.36%,
3606.HK,0,0,0,0,1,0,1,0.00%,
3668.HK,1,0,0,0,0,0,1,100.00%,
3690.HK,0,0,0,0,1,0,1,0.00%,
3800.HK,0,0,1,1,0,0,2,50.00%,
3808.HK,3,1,0,0,6,0,10,40.00%,
3939.HK,1,0,0,0,3,0,4,25.00%,
3968.HK,3,0,0,0,2,2,7,42.86%,
6088.HK,1,0,0,0,2,1,4,25.00%,
6186.HK,0,0,0,0,2,0,2,0.00%,
6690.HK,1,0,0,1,2,0,4,25.00%,
6823.HK,2,0,1,0,3,0,6,50.00%,
6862.HK,1,0,0,0,0,0,1,100.00%,
6969.HK,2,0,0,2,0,0,4,50.00%,
6979.HK,1,0,0,0,0,2,3,33.33%,
9618.HK,0,0,0,0,1,0,1,0.00%,
9633.HK,1,0,0,0,0,0,1,100.00%,
9863.HK,0,0,0,0,1,0,1,0.00%,
9866.HK,0,0,0,0,1,0,1,0.00%,
9868.HK,0,0,0,1,1,0,2,0.00%,
9888.HK,1,0,0,0,2,0,3,33.33%,
9896.HK,2,0,0,0,1,0,3,66.67%,
9961.HK,1,0,0,1,1,0,3,33.33%,
9988.HK,2,0,0,1,0,0,3,66.67%,
9992.HK,1,0,0,0,2,0,3,33.33%,
,347,54,31,79,454,78,1043,41.42%,278
