sno,TP12,TP1,TP2,TP1C,CL1,BY1,,
0001.HK,5,0,0,0,6,0,11,45.45%
0002.HK,2,0,1,1,2,0,6,50.00%
0004.HK,6,0,2,0,5,0,13,61.54%
0005.HK,0,0,0,2,9,0,11,0.00%
0006.HK,0,1,0,0,0,1,2,50.00%
0008.HK,1,0,0,1,7,0,9,11.11%
0011.HK,3,0,2,3,2,0,10,50.00%
0012.HK,8,0,0,1,11,0,20,40.00%
0016.HK,2,1,0,1,2,1,7,42.86%
0019.HK,3,2,1,2,7,0,15,40.00%
0020.HK,0,0,0,0,2,0,2,0.00%
0023.HK,2,1,1,1,2,0,7,57.14%
0027.HK,4,0,0,0,5,1,10,40.00%
0066.HK,4,0,0,4,4,0,12,33.33%
0083.HK,4,0,0,3,3,0,10,40.00%
0087.HK,3,0,0,2,5,0,10,30.00%
0101.HK,1,2,0,0,2,0,5,60.00%
0135.HK,1,1,0,0,1,0,3,66.67%
0136.HK,0,1,0,1,1,1,4,25.00%
0144.HK,6,1,0,0,3,0,10,70.00%
0148.HK,2,1,0,0,7,1,11,27.27%
0151.HK,2,1,1,0,4,0,8,50.00%
0168.HK,5,0,1,1,2,1,10,60.00%
0175.HK,1,0,0,0,3,0,4,25.00%
0179.HK,2,0,0,2,7,0,11,18.18%
0220.HK,1,0,0,3,2,0,6,16.67%
0241.HK,1,0,0,0,2,1,4,25.00%
0247.HK,0,0,0,0,1,0,1,0.00%
0267.HK,2,0,0,0,2,0,4,50.00%
0268.HK,2,0,0,0,1,0,3,66.67%
0270.HK,0,1,0,1,5,0,7,14.29%
0285.HK,2,0,0,2,1,1,6,33.33%
0288.HK,1,0,0,0,3,0,4,25.00%
0291.HK,3,1,0,0,5,0,9,44.44%
0293.HK,5,0,1,5,6,0,17,35.29%
0300.HK,1,0,0,0,0,0,1,100.00%
0316.HK,0,1,0,0,4,0,5,20.00%
0322.HK,1,0,1,3,4,0,9,22.22%
0358.HK,2,1,0,1,2,2,8,37.50%
0384.HK,4,0,0,2,4,1,11,36.36%
0386.HK,3,0,0,1,8,0,12,25.00%
0388.HK,5,0,0,1,5,0,11,45.45%
0392.HK,4,1,0,1,5,0,11,45.45%
0425.HK,3,0,1,0,2,0,6,66.67%
0486.HK,1,0,0,1,2,1,5,20.00%
0522.HK,3,0,0,0,6,0,9,33.33%
0656.HK,2,0,0,1,6,0,9,22.22%
0659.HK,1,0,0,0,3,0,4,25.00%
0669.HK,7,0,0,1,2,0,10,70.00%
0700.HK,4,0,0,1,1,0,6,66.67%
0728.HK,2,0,0,1,4,0,7,28.57%
0753.HK,2,0,1,1,4,0,8,37.50%
0762.HK,2,1,1,1,6,1,12,33.33%
0763.HK,2,1,0,1,0,1,5,60.00%
0772.HK,1,0,0,0,8,0,9,11.11%
0780.HK,1,1,0,0,0,0,2,100.00%
0788.HK,0,0,0,0,3,0,3,0.00%
0836.HK,2,1,0,1,4,0,8,37.50%
0857.HK,2,0,0,1,2,0,5,40.00%
0867.HK,0,0,0,0,4,0,4,0.00%
0868.HK,0,0,0,1,1,1,3,0.00%
0881.HK,3,0,0,3,2,0,8,37.50%
0883.HK,3,0,0,1,2,0,6,50.00%
0914.HK,4,0,0,1,3,1,9,44.44%
0939.HK,4,0,0,0,5,0,9,44.44%
0941.HK,3,0,0,0,1,0,4,75.00%
0945.HK,3,0,1,0,9,0,13,30.77%
0966.HK,4,0,0,1,5,0,10,40.00%
0968.HK,0,1,0,2,0,0,3,33.33%
0981.HK,1,1,0,0,3,0,5,40.00%
0992.HK,2,0,0,0,2,1,5,40.00%
0998.HK,2,0,0,0,2,0,4,50.00%
1024.HK,1,0,0,0,1,0,2,50.00%
1038.HK,4,0,0,0,5,0,9,44.44%
1044.HK,0,0,0,1,5,0,6,0.00%
1088.HK,2,1,0,0,4,1,8,37.50%
1093.HK,2,0,0,0,3,1,6,33.33%
1128.HK,2,0,1,1,2,1,7,42.86%
1171.HK,5,0,0,1,9,0,15,33.33%
1177.HK,1,0,0,0,4,0,5,20.00%
1179.HK,0,0,0,0,1,0,1,0.00%
1193.HK,3,0,0,3,7,0,13,23.08%
1208.HK,1,0,0,3,2,0,6,16.67%
1209.HK,2,0,0,0,0,0,2,100.00%
1211.HK,4,1,0,0,1,0,6,83.33%
1258.HK,1,0,0,0,3,0,4,25.00%
1276.HK,1,0,0,0,0,0,1,100.00%
1288.HK,3,0,1,2,4,0,10,40.00%
1299.HK,1,0,0,0,2,0,3,33.33%
1308.HK,2,1,0,0,2,1,6,50.00%
1336.HK,0,0,1,0,1,0,2,50.00%
1339.HK,0,0,0,0,0,1,1,0.00%
1347.HK,3,0,0,1,2,1,7,42.86%
1357.HK,1,0,0,0,0,0,1,100.00%
1378.HK,1,0,0,1,1,0,3,33.33%
1398.HK,1,0,0,3,5,0,9,11.11%
1519.HK,0,0,0,1,0,0,1,0.00%
1530.HK,1,0,0,0,2,0,3,33.33%
1548.HK,2,0,0,0,4,1,7,28.57%
1585.HK,2,1,0,0,3,1,7,42.86%
1658.HK,1,1,0,2,2,0,6,33.33%
1698.HK,0,0,0,0,1,0,1,0.00%
1729.HK,2,0,0,0,0,1,3,66.67%
1735.HK,0,0,1,1,1,0,3,33.33%
1776.HK,1,0,0,0,3,0,4,25.00%
1787.HK,2,0,0,1,2,0,5,40.00%
1788.HK,2,0,0,0,1,0,3,66.67%
1801.HK,2,0,0,0,1,0,3,66.67%
1810.HK,0,1,0,0,2,0,3,33.33%
1816.HK,4,0,0,0,3,0,7,57.14%
1818.HK,1,0,0,0,2,0,3,33.33%
1833.HK,0,0,0,1,1,0,2,0.00%
1876.HK,3,0,0,0,2,0,5,60.00%
1882.HK,2,0,0,1,3,1,7,28.57%
1888.HK,0,0,0,2,4,0,6,0.00%
1898.HK,3,0,0,1,1,0,5,60.00%
1913.HK,2,0,0,0,1,1,4,50.00%
1919.HK,4,0,0,0,2,1,7,57.14%
1928.HK,0,0,0,0,3,0,3,0.00%
1929.HK,0,0,0,0,2,1,3,0.00%
1988.HK,2,2,0,0,1,1,6,66.67%
2015.HK,0,0,0,0,1,0,1,0.00%
2018.HK,3,0,0,1,3,0,7,42.86%
2020.HK,2,0,1,0,1,0,4,75.00%
2057.HK,0,0,0,0,0,1,1,0.00%
2096.HK,0,0,0,0,1,1,2,0.00%
2097.HK,0,0,0,0,0,1,1,0.00%
2099.HK,2,0,1,0,1,0,4,75.00%
2269.HK,2,0,0,0,3,0,5,40.00%
2282.HK,2,0,2,1,3,0,8,50.00%
2318.HK,4,0,1,0,3,0,8,62.50%
2319.HK,3,2,0,2,7,1,15,33.33%
2328.HK,3,0,2,1,1,0,7,71.43%
2331.HK,1,0,0,1,7,0,9,11.11%
2333.HK,1,0,0,0,5,0,6,16.67%
2359.HK,1,0,0,1,0,0,2,50.00%
2367.HK,0,0,0,1,2,0,3,0.00%
2378.HK,1,0,1,1,6,0,9,22.22%
2380.HK,3,1,0,1,0,1,6,66.67%
2382.HK,1,0,0,0,2,0,3,33.33%
2388.HK,2,0,1,0,6,1,10,30.00%
2400.HK,0,0,0,1,3,0,4,0.00%
2588.HK,1,0,0,0,0,0,1,100.00%
2600.HK,5,0,0,0,1,0,6,83.33%
2601.HK,1,0,0,0,4,1,6,16.67%
2618.HK,0,0,0,0,3,0,3,0.00%
2628.HK,4,0,0,0,4,0,8,50.00%
2638.HK,0,0,0,0,3,0,3,0.00%
2688.HK,2,1,1,1,3,2,10,40.00%
2799.HK,1,0,0,0,1,1,3,33.33%
2888.HK,4,0,1,1,10,0,16,31.25%
2899.HK,0,0,0,0,2,0,2,0.00%
3328.HK,4,0,1,0,6,1,12,41.67%
3606.HK,1,0,1,0,1,0,3,66.67%
3668.HK,1,0,0,0,0,0,1,100.00%
3690.HK,2,0,0,0,1,0,3,66.67%
3800.HK,1,0,0,2,0,0,3,33.33%
3808.HK,1,1,0,0,5,2,9,22.22%
3939.HK,1,0,1,0,1,0,3,66.67%
3968.HK,4,0,0,0,2,0,6,66.67%
6088.HK,2,0,1,0,3,0,6,50.00%
6181.HK,0,0,0,0,1,0,1,0.00%
6186.HK,0,0,0,0,1,0,1,0.00%
6690.HK,1,0,0,0,3,0,4,25.00%
6823.HK,0,0,0,1,3,0,4,0.00%
6862.HK,2,0,0,1,1,0,4,50.00%
6969.HK,2,0,0,0,1,0,3,66.67%
83690.HK,0,0,0,0,1,0,1,0.00%
9618.HK,0,0,0,0,2,0,2,0.00%
9633.HK,3,0,0,0,1,0,4,75.00%
9863.HK,1,0,0,0,1,0,2,50.00%
9866.HK,0,0,0,0,2,0,2,0.00%
9868.HK,0,0,0,1,0,0,1,0.00%
9888.HK,0,0,0,0,2,0,2,0.00%
9896.HK,2,0,0,0,1,0,3,66.67%
9961.HK,0,0,0,0,1,0,1,0.00%
9988.HK,1,0,0,1,1,0,3,33.33%
9992.HK,1,0,1,1,1,0,4,50.00%
9999.HK,2,0,0,0,2,0,4,50.00%
,326,36,35,110,495,44,1046,37.95%
