sno,TP12,TP1,TP2,TP1C,CL1,BY1,,
0010.HK,2,0,0,1,3,0,6,
0013.HK,0,1,0,2,2,0,5,
0014.HK,2,0,0,2,5,0,9,
0017.HK,3,0,0,1,5,0,9,
0026.HK,1,0,0,1,3,0,5,
0028.HK,4,0,1,0,2,0,7,
0029.HK,1,0,1,1,1,0,4,
0032.HK,5,0,1,2,5,0,13,
0034.HK,4,0,0,0,3,0,7,
0035.HK,4,0,1,1,4,0,10,
0038.HK,1,0,1,1,2,0,5,
0041.HK,7,0,1,1,8,1,18,
0045.HK,2,0,0,1,5,0,8,
0051.HK,7,0,0,1,5,1,14,
0053.HK,4,0,0,0,2,0,6,
0062.HK,3,0,1,1,2,0,7,
0069.HK,3,0,0,1,3,0,7,
0071.HK,3,0,0,2,4,0,9,
0081.HK,3,0,0,1,2,1,7,
0085.HK,3,0,0,0,3,1,7,
0086.HK,3,0,0,0,2,0,5,
0098.HK,6,0,1,0,1,0,8,
0103.HK,4,0,3,0,2,0,9,
0107.HK,4,0,0,0,1,0,5,
0108.HK,1,0,0,0,2,0,3,
0116.HK,1,0,1,0,3,0,5,
0119.HK,3,0,0,0,4,1,8,
0123.HK,3,0,0,0,5,0,8,
0127.HK,3,0,1,0,4,0,8,
0133.HK,1,0,0,0,2,0,3,
0142.HK,8,0,0,3,5,0,16,
0147.HK,4,0,1,0,3,0,8,
0148.HK,3,0,0,0,7,1,11,
0152.HK,2,1,0,1,3,0,7,
0165.HK,1,0,1,1,7,0,10,
0169.HK,5,0,0,2,3,0,10,
0173.HK,2,0,1,2,0,0,5,
0177.HK,6,0,0,0,1,0,7,
0182.HK,2,1,1,0,2,0,6,
0189.HK,4,0,0,0,3,0,7,
0200.HK,2,0,0,0,4,0,6,
0207.HK,1,0,0,0,2,0,3,
0215.HK,1,0,0,0,2,0,3,
0218.HK,3,0,0,3,2,0,8,
0242.HK,3,0,1,3,4,0,11,
0245.HK,1,0,0,0,4,1,6,
0257.HK,0,0,2,1,4,1,8,
0258.HK,3,0,1,0,2,0,6,
0259.HK,1,0,1,0,2,0,4,
0272.HK,4,0,0,2,4,0,10,
0289.HK,4,0,0,0,5,0,9,
0290.HK,0,0,1,1,0,0,2,
0297.HK,2,0,0,0,4,0,6,
0303.HK,0,0,0,3,1,0,4,
0308.HK,3,0,1,0,2,0,6,
0315.HK,4,0,0,1,1,0,6,
0317.HK,2,0,0,3,1,0,6,
0323.HK,7,0,0,2,2,0,11,
0326.HK,2,0,1,1,0,1,5,
0327.HK,3,0,1,3,2,0,9,
0331.HK,0,0,0,0,1,0,1,
0336.HK,3,0,1,0,4,0,8,
0338.HK,3,0,0,2,1,0,6,
0340.HK,3,0,0,0,3,0,6,
0341.HK,5,0,0,1,4,0,10,
0345.HK,6,0,0,0,1,0,7,
0347.HK,2,0,1,1,4,0,8,
0354.HK,3,1,1,0,3,0,8,
0357.HK,3,1,0,2,3,0,9,
0363.HK,4,1,1,2,4,0,12,
0369.HK,3,0,2,1,4,0,10,
0370.HK,0,0,1,1,1,0,3,
0371.HK,0,1,0,0,5,0,6,
0373.HK,5,0,0,0,6,0,11,
0376.HK,2,0,1,1,6,0,10,
0390.HK,2,0,0,1,3,0,6,
0400.HK,1,0,0,0,2,0,3,
0410.HK,2,0,0,2,5,0,9,
0411.HK,0,0,1,0,0,0,1,
0412.HK,1,0,0,1,4,0,6,
0434.HK,2,0,0,0,3,0,5,
0440.HK,7,0,0,3,3,0,13,
0460.HK,4,0,0,0,5,0,9,
0467.HK,1,0,0,1,2,1,5,
0468.HK,2,0,0,1,0,0,3,
0489.HK,6,0,1,0,0,1,8,
0506.HK,4,0,0,2,4,0,10,
0512.HK,4,0,3,2,1,0,10,
0517.HK,0,0,0,0,2,0,2,
0521.HK,3,0,1,1,4,0,9,
0525.HK,2,0,1,1,3,0,7,
0546.HK,7,0,0,1,4,0,12,
0547.HK,1,0,1,0,4,0,6,
0548.HK,6,0,0,0,4,0,10,
0551.HK,3,0,0,1,1,0,5,
0552.HK,2,0,0,0,2,0,4,
0558.HK,3,0,0,0,4,0,7,
0564.HK,3,0,0,0,1,0,4,
0565.HK,5,0,0,1,3,0,9,
0570.HK,1,0,0,2,2,0,5,
0576.HK,5,1,0,3,4,0,13,
0579.HK,1,0,0,1,1,0,3,
0580.HK,3,0,0,0,1,0,4,
0581.HK,4,0,1,2,2,0,9,
0586.HK,2,0,0,0,2,0,4,
0590.HK,4,1,2,0,3,0,10,
0596.HK,3,0,0,0,0,0,3,
0598.HK,3,0,0,1,2,0,6,
0604.HK,3,0,0,1,0,0,4,
0613.HK,1,0,0,0,1,0,2,
0622.HK,2,0,1,1,7,0,11,
0631.HK,1,0,0,1,4,0,6,
0636.HK,1,0,1,0,3,0,5,
0639.HK,2,0,0,0,3,0,5,
0658.HK,4,0,0,2,5,0,11,
0662.HK,2,0,0,1,1,1,5,
0667.HK,2,0,0,1,0,0,3,
0670.HK,5,0,0,1,9,0,15,
0686.HK,4,0,0,0,5,0,9,
0691.HK,1,0,0,1,3,0,5,
0693.HK,1,0,0,2,2,0,5,
0694.HK,2,0,0,0,3,0,5,
0695.HK,1,0,0,2,2,0,5,
0696.HK,2,0,0,0,3,0,5,
0697.HK,4,0,0,0,3,0,7,
0709.HK,4,0,1,2,8,0,15,
0710.HK,1,0,0,0,7,0,8,
0732.HK,1,0,0,1,10,0,12,
0737.HK,2,1,1,0,2,0,6,
0743.HK,3,0,0,2,2,0,7,
0746.HK,2,0,0,0,1,0,3,
0751.HK,3,0,0,0,3,0,6,
0752.HK,0,0,0,0,2,0,2,
0753.HK,4,1,1,0,5,0,11,
0763.HK,4,0,0,1,3,0,8,
0775.HK,2,0,0,0,2,1,5,
0777.HK,3,0,0,2,7,0,12,
0797.HK,1,0,0,0,0,0,1,
0799.HK,0,0,0,1,5,1,7,
0806.HK,2,1,1,2,5,0,11,
0807.HK,0,0,0,1,0,0,1,
0811.HK,3,0,0,0,2,0,5,
0815.HK,2,0,0,0,1,0,3,
0816.HK,0,0,0,1,0,0,1,
0819.HK,6,0,0,0,6,0,12,
0826.HK,2,0,0,1,1,0,4,
0830.HK,2,0,0,1,2,0,5,
0837.HK,0,0,0,0,2,0,2,
0838.HK,3,0,1,0,2,0,6,
0839.HK,1,0,0,0,1,0,2,
0842.HK,2,0,0,0,3,0,5,
0853.HK,1,2,0,1,3,0,7,
0855.HK,5,1,2,2,5,0,15,
0856.HK,2,0,0,0,0,0,2,
0861.HK,2,0,2,0,3,0,7,
0863.HK,4,1,0,0,0,0,5,
0866.HK,4,0,0,0,1,0,5,
0874.HK,5,0,0,0,1,0,6,
0880.HK,3,0,0,0,0,0,3,
0882.HK,3,0,0,1,1,0,5,
0887.HK,1,0,0,0,1,0,2,
0900.HK,4,0,1,0,1,0,6,
0902.HK,8,0,0,2,7,0,17,
0909.HK,1,0,0,0,2,0,3,
0916.HK,2,1,0,2,2,0,7,
0921.HK,5,0,0,1,3,0,9,
0931.HK,0,0,0,0,1,0,1,
0934.HK,5,0,1,2,2,0,10,
0956.HK,2,0,0,0,1,0,3,
0975.HK,1,0,0,0,1,0,2,
0990.HK,2,0,0,1,3,0,6,
0991.HK,7,0,0,1,4,0,12,
0995.HK,6,0,0,1,5,0,12,
1033.HK,1,0,1,3,4,1,10,
1050.HK,2,0,2,2,2,0,8,
1051.HK,1,0,0,2,1,0,4,
1052.HK,2,0,1,3,4,0,10,
1055.HK,3,0,0,2,1,0,6,
1060.HK,1,0,0,1,2,0,4,
1061.HK,3,0,0,0,3,0,6,
1066.HK,0,0,1,2,0,1,4,
1070.HK,5,0,1,5,1,0,12,
1071.HK,7,0,0,2,1,0,10,
1072.HK,2,0,0,1,2,1,6,
1083.HK,5,0,0,1,5,0,11,
1086.HK,1,0,0,0,1,0,2,
1091.HK,1,0,2,0,0,0,3,
1099.HK,4,0,0,0,1,0,5,
1104.HK,1,0,0,1,6,0,8,
1112.HK,2,1,0,0,5,0,8,
1114.HK,2,0,2,1,7,0,12,
1115.HK,2,0,0,0,0,0,2,
1117.HK,3,0,1,1,2,0,7,
1119.HK,1,0,0,1,3,0,5,
1121.HK,2,0,0,1,4,1,8,
1126.HK,3,0,0,0,4,0,7,
1133.HK,6,0,0,1,1,0,8,
1138.HK,6,0,0,3,6,0,15,
1140.HK,1,0,1,1,3,0,6,
1157.HK,2,0,1,1,5,0,9,
1164.HK,0,0,0,1,2,0,3,
1167.HK,0,0,0,0,1,0,1,
1168.HK,1,0,1,1,3,0,6,
1184.HK,4,0,1,0,2,0,7,
1186.HK,3,0,0,0,5,0,8,
1196.HK,1,0,1,1,4,0,7,
1199.HK,6,0,0,5,2,0,13,
1205.HK,2,0,0,1,1,1,5,
1223.HK,1,0,0,0,3,1,5,
1224.HK,4,0,1,0,4,0,9,
1234.HK,0,0,0,0,3,0,3,
1250.HK,2,1,0,0,1,0,4,
1263.HK,3,0,0,1,1,0,5,
1268.HK,0,0,0,0,1,0,1,
1277.HK,0,0,0,0,1,0,1,
1280.HK,1,0,1,1,0,0,3,
1302.HK,3,1,0,0,5,1,10,
1310.HK,2,0,1,0,3,0,6,
1313.HK,2,0,1,0,3,1,7,
1316.HK,6,0,0,0,0,0,6,
1330.HK,2,0,0,0,2,0,4,
1333.HK,0,1,0,0,0,0,1,
1341.HK,0,0,0,0,3,0,3,
1345.HK,1,1,0,0,3,0,5,
1358.HK,0,0,0,0,1,0,1,
1359.HK,0,0,1,0,2,0,3,
1361.HK,3,0,0,0,1,0,4,
1368.HK,4,0,0,2,4,0,10,
1375.HK,0,0,1,2,0,0,3,
1382.HK,1,0,0,0,3,2,6,
1385.HK,2,0,0,1,2,0,5,
1405.HK,1,0,0,0,0,0,1,
1415.HK,2,0,1,1,0,0,4,
1440.HK,1,0,0,0,0,0,1,
1448.HK,2,2,0,0,5,0,9,
1456.HK,2,0,4,0,0,1,7,
1458.HK,2,0,0,0,1,0,3,
1475.HK,1,0,0,0,1,0,2,
1477.HK,0,0,0,1,3,0,4,
1478.HK,2,0,1,0,4,0,7,
1501.HK,1,0,0,0,1,0,2,
1508.HK,0,0,0,0,5,0,5,
1513.HK,2,0,0,0,3,0,5,
1515.HK,1,0,0,0,3,0,4,
1516.HK,1,0,0,0,0,0,1,
1521.HK,1,0,0,0,2,0,3,
1523.HK,3,0,0,0,0,0,3,
1551.HK,0,1,0,1,0,1,3,
1571.HK,1,0,0,0,1,0,2,
1578.HK,0,0,0,0,2,1,3,
1579.HK,2,0,0,0,2,0,4,
1600.HK,3,0,0,0,1,0,4,
1606.HK,0,0,0,1,0,1,2,
1610.HK,2,1,1,0,3,0,7,
1611.HK,0,0,0,1,1,0,2,
1618.HK,5,0,0,1,2,1,9,
1635.HK,0,0,0,0,1,0,1,
1640.HK,0,0,0,0,1,1,2,
1651.HK,2,0,0,0,5,0,7,
1660.HK,0,0,1,0,0,0,1,
1666.HK,2,0,0,0,4,0,6,
1672.HK,0,0,0,0,2,0,2,
1681.HK,2,0,0,0,0,0,2,
1686.HK,3,1,1,2,3,0,10,
1691.HK,0,1,0,0,1,1,3,
1696.HK,0,0,0,0,1,0,1,
1709.HK,2,0,1,0,2,0,5,
1717.HK,1,0,0,1,1,0,3,
1729.HK,4,0,0,0,1,0,5,
1733.HK,0,0,0,1,2,0,3,
1755.HK,0,0,0,0,1,0,1,
1766.HK,5,0,0,2,5,0,12,
1772.HK,3,0,0,0,0,0,3,
1773.HK,4,0,0,0,0,0,4,
1782.HK,1,0,0,0,1,0,2,
1789.HK,0,0,0,0,1,0,1,
1797.HK,2,0,0,1,3,0,6,
1798.HK,2,0,0,2,2,0,6,
1799.HK,1,0,0,0,1,0,2,
1800.HK,1,0,0,1,2,0,4,
1809.HK,0,0,0,2,2,0,4,
1811.HK,1,0,0,0,2,0,3,
1815.HK,0,0,1,0,2,0,3,
1836.HK,2,0,1,1,3,0,7,
1837.HK,1,0,1,0,2,0,4,
1848.HK,0,0,0,0,1,0,1,
1857.HK,1,0,0,0,0,1,2,
1860.HK,2,0,0,0,1,0,3,
1866.HK,2,0,0,0,3,1,6,
1872.HK,0,0,0,2,0,0,2,
1873.HK,2,0,0,0,2,0,4,
1877.HK,1,0,1,1,0,0,3,
1880.HK,0,0,0,0,1,0,1,
1883.HK,1,0,0,0,0,0,1,
1890.HK,1,0,0,0,1,0,2,
1896.HK,0,0,0,1,1,0,2,
1899.HK,1,0,0,1,0,0,2,
1905.HK,1,0,0,0,0,0,1,
1907.HK,1,0,0,1,1,0,3,
1910.HK,2,3,1,1,2,0,9,
1911.HK,0,0,0,0,1,0,1,
1931.HK,0,0,0,1,2,0,3,
1939.HK,0,0,0,0,1,0,1,
1948.HK,0,0,0,0,1,0,1,
1951.HK,1,0,0,0,1,0,2,
1952.HK,1,0,1,0,1,0,3,
1958.HK,2,0,0,0,2,0,4,
1963.HK,2,0,0,0,3,0,5,
1969.HK,0,0,0,0,2,0,2,
1970.HK,0,0,0,1,0,0,1,
1979.HK,0,0,1,0,1,0,2,
1982.HK,0,0,0,0,1,0,1,
1995.HK,0,0,0,0,1,0,1,
1999.HK,1,0,0,1,2,0,4,
2001.HK,0,0,0,2,0,0,2,
2005.HK,3,0,1,0,2,1,7,
2009.HK,1,0,0,0,2,0,3,
2013.HK,0,0,0,0,3,0,3,
2016.HK,0,0,0,0,3,0,3,
2025.HK,1,0,0,0,0,0,1,
2038.HK,2,0,1,0,4,0,7,
2039.HK,1,0,0,0,4,0,5,
2066.HK,4,0,0,1,2,0,7,
2111.HK,1,0,0,0,0,0,1,
2121.HK,0,0,0,1,1,0,2,
2128.HK,3,0,0,0,5,0,8,
2142.HK,2,0,0,1,0,0,3,
2150.HK,0,0,0,0,2,0,2,
2155.HK,2,0,0,0,1,0,3,
2157.HK,1,0,1,0,0,0,2,
2158.HK,0,0,1,0,1,0,2,
2160.HK,1,0,0,0,1,0,2,
2161.HK,1,0,0,0,0,0,1,
2162.HK,1,0,0,0,0,0,1,
2171.HK,0,0,0,0,1,0,1,
2172.HK,0,1,0,0,2,0,3,
2179.HK,0,0,0,1,1,0,2,
2185.HK,0,1,0,1,2,0,4,
2186.HK,0,0,0,2,1,0,3,
2190.HK,2,0,0,0,0,0,2,
2192.HK,1,0,0,0,0,0,1,
2196.HK,1,0,0,1,4,0,6,
2197.HK,0,0,1,0,1,0,2,
2198.HK,2,0,0,1,1,0,4,
2208.HK,3,0,0,0,2,0,5,
2209.HK,1,0,0,0,0,0,1,
2225.HK,0,0,0,1,0,0,1,
2233.HK,7,0,1,1,3,0,12,
2238.HK,11,0,1,2,5,1,20,
2245.HK,0,0,0,1,0,0,1,
2252.HK,2,0,1,0,0,0,3,
2255.HK,3,0,0,0,2,0,5,
2256.HK,1,0,0,0,1,0,2,
2273.HK,0,1,0,0,0,0,1,
2276.HK,0,0,0,0,1,0,1,
2283.HK,0,1,0,0,1,1,3,
2285.HK,0,0,0,0,1,0,1,
2299.HK,0,1,0,0,0,1,2,
2302.HK,3,0,0,1,2,0,6,
2306.HK,0,1,0,0,0,0,1,
2314.HK,6,0,1,1,6,0,14,
2315.HK,1,0,0,0,0,0,1,
2338.HK,3,0,0,1,6,0,10,
2342.HK,10,0,0,0,2,0,12,
2343.HK,5,0,0,2,3,0,10,
2356.HK,3,0,2,0,3,0,8,
2357.HK,6,1,0,1,6,0,14,
2360.HK,0,0,0,1,0,0,1,
2362.HK,2,0,0,0,1,2,5,
2368.HK,1,1,0,1,1,0,4,
2386.HK,5,0,0,1,3,0,9,
2390.HK,1,0,0,0,2,0,3,
2391.HK,1,0,0,0,1,0,2,
2410.HK,0,0,0,0,0,1,1,
2411.HK,0,0,0,0,1,0,1,
2429.HK,0,0,0,0,0,1,1,
2443.HK,1,0,0,0,0,0,1,
2451.HK,0,0,0,0,1,0,1,
2469.HK,0,0,0,0,1,0,1,
2490.HK,0,0,0,0,2,0,2,
2498.HK,0,0,1,0,0,0,1,
2517.HK,0,0,0,1,0,0,1,
2518.HK,2,0,0,0,2,0,4,
2552.HK,1,0,0,1,1,0,3,
2555.HK,0,1,0,0,0,0,1,
2585.HK,1,0,0,0,0,0,1,
2598.HK,1,0,0,0,0,1,2,
2616.HK,0,0,0,1,0,0,1,
2660.HK,1,0,1,0,1,0,3,
2678.HK,2,0,0,0,3,0,5,
2689.HK,3,0,0,3,2,0,8,
2727.HK,5,0,0,0,3,0,8,
2858.HK,0,0,0,0,1,0,1,
2866.HK,1,0,0,0,5,0,6,
2880.HK,3,0,1,0,2,0,6,
2883.HK,5,0,2,1,1,0,9,
3323.HK,5,0,0,1,2,0,8,
3330.HK,1,0,0,2,4,0,7,
3336.HK,3,0,0,1,5,0,9,
3337.HK,1,0,0,0,3,0,4,
3339.HK,3,0,0,1,3,0,7,
3347.HK,0,0,1,0,0,1,2,
3369.HK,1,0,0,1,0,0,2,
3382.HK,4,0,0,0,1,0,5,
3396.HK,1,0,0,1,1,0,3,
3600.HK,0,0,1,0,1,1,3,
3613.HK,4,0,0,1,3,0,8,
3618.HK,2,0,0,0,4,0,6,
3633.HK,2,0,1,2,6,0,11,
3650.HK,1,0,0,0,0,0,1,
3669.HK,2,0,0,2,1,0,5,
3681.HK,0,1,0,0,1,0,2,
3698.HK,3,0,0,0,3,0,6,
3700.HK,1,0,1,0,0,0,2,
3759.HK,1,0,0,0,1,0,2,
3813.HK,6,0,0,0,2,0,8,
3818.HK,2,0,0,0,1,0,3,
3833.HK,2,0,1,0,6,0,9,
3866.HK,2,0,0,1,1,0,4,
3868.HK,2,0,0,0,0,0,2,
3877.HK,1,0,0,2,0,0,3,
3898.HK,6,0,0,0,3,0,9,
3899.HK,4,0,0,1,8,0,13,
3918.HK,3,0,0,4,0,0,7,
3931.HK,3,0,0,0,0,0,3,
3969.HK,4,1,1,1,1,0,8,
3983.HK,5,0,0,3,2,0,10,
3996.HK,1,0,1,0,2,0,4,
6055.HK,1,0,0,0,2,0,3,
6060.HK,0,1,0,0,1,0,2,
6110.HK,0,1,0,0,0,0,1,
6198.HK,2,0,0,1,3,0,6,
6288.HK,1,0,0,0,0,0,1,
6601.HK,2,0,0,0,1,0,3,
6616.HK,1,0,0,0,1,0,2,
6655.HK,1,0,0,0,0,0,1,
6676.HK,0,0,0,1,0,0,1,
6808.HK,2,0,0,1,5,0,8,
6858.HK,0,0,0,0,1,0,1,
6865.HK,0,1,0,0,3,0,4,
6868.HK,0,0,0,0,1,0,1,
6869.HK,0,0,0,0,2,0,2,
6889.HK,1,1,0,1,2,0,5,
6896.HK,2,0,0,0,2,0,4,
6963.HK,1,0,0,0,0,0,1,
6993.HK,2,0,0,0,1,0,3,
8137.HK,2,0,0,0,4,0,6,
8279.HK,0,0,0,1,2,0,3,
8299.HK,0,0,0,1,3,0,4,
9638.HK,1,0,0,0,0,0,1,
9676.HK,1,0,0,0,0,0,1,
9858.HK,0,0,0,0,1,0,1,
9879.HK,0,0,0,1,0,0,1,
9890.HK,1,0,0,0,0,0,1,
9898.HK,1,0,0,0,2,0,3,
9911.HK,3,0,0,0,1,0,4,
9933.HK,0,0,0,0,0,1,1,
9956.HK,0,0,0,0,1,0,1,
9996.HK,2,0,0,1,0,0,3,
9997.HK,2,0,0,1,0,0,3,
,932,46,120,277,980,45,2400,0.572916667
