sno,TP12,TP1,TP2,TP1C,CL1,BY1,,,
0007.HK,0,0,0,0,4,1,5,0.00%,
0009.HK,1,0,0,0,2,0,3,33.33%,
0018.HK,1,0,0,0,0,0,1,100.00%,
0021.HK,0,0,0,0,0,1,1,0.00%,
0022.HK,0,0,1,0,1,0,2,50.00%,
0025.HK,1,1,1,1,1,0,5,60.00%,
0030.HK,0,1,2,0,0,0,3,100.00%,
0031.HK,0,0,0,0,1,0,1,0.00%,
0033.HK,0,0,0,0,2,0,2,0.00%,
0036.HK,0,0,0,3,2,0,5,0.00%,
0037.HK,1,0,0,0,0,0,1,100.00%,
0039.HK,0,0,0,0,1,0,1,0.00%,
0040.HK,0,0,0,1,0,0,1,0.00%,
0042.HK,0,0,0,0,3,0,3,0.00%,
0048.HK,0,0,0,1,0,0,1,0.00%,
0050.HK,0,0,1,1,0,0,2,50.00%,
0052.HK,0,0,2,0,6,1,9,22.22%,
0055.HK,0,0,0,1,0,0,1,0.00%,
0057.HK,2,0,0,0,2,1,5,40.00%,
0058.HK,0,0,0,0,1,0,1,0.00%,
0059.HK,1,0,0,1,0,0,2,50.00%,
0061.HK,0,0,0,0,3,0,3,0.00%,
0063.HK,1,0,1,0,0,0,2,100.00%,
0065.HK,0,0,0,0,4,0,4,0.00%,
0070.HK,0,0,2,1,0,0,3,66.67%,
0072.HK,1,0,1,0,1,0,3,66.67%,
0073.HK,0,0,1,1,3,1,6,16.67%,
0075.HK,0,0,0,0,1,0,1,0.00%,
0076.HK,2,0,0,0,0,0,2,100.00%,
0077.HK,0,0,0,1,1,0,2,0.00%,
0078.HK,1,0,0,0,2,0,3,33.33%,
0079.HK,0,1,0,0,0,0,1,100.00%,
0080.HK,0,0,0,1,4,0,5,0.00%,
0082.HK,0,0,0,1,0,0,1,0.00%,
0088.HK,0,0,1,1,1,0,3,33.33%,
0089.HK,0,0,0,0,1,0,1,0.00%,
0090.HK,0,0,0,1,2,0,3,0.00%,
0092.HK,0,0,2,0,3,0,5,40.00%,
0093.HK,0,0,0,0,1,0,1,0.00%,
0094.HK,0,0,0,0,2,0,2,0.00%,
0095.HK,1,0,0,1,1,0,3,33.33%,
0097.HK,1,0,1,0,0,1,3,66.67%,
0104.HK,2,0,0,1,0,0,3,66.67%,
0105.HK,0,0,0,0,0,1,1,0.00%,
0106.HK,2,0,0,0,1,0,3,66.67%,
0110.HK,0,0,1,0,0,0,1,100.00%,
0111.HK,0,0,0,1,1,0,2,0.00%,
0114.HK,0,0,0,0,2,0,2,0.00%,
0117.HK,0,0,0,1,0,0,1,0.00%,
0118.HK,2,0,1,0,0,0,3,100.00%,
0120.HK,0,0,0,0,2,0,2,0.00%,
0122.HK,0,1,1,1,1,0,4,50.00%,
0124.HK,1,0,1,0,2,0,4,50.00%,
0126.HK,0,0,0,1,2,0,3,0.00%,
0129.HK,2,1,0,0,0,0,3,100.00%,
0130.HK,0,0,0,0,1,0,1,0.00%,
0131.HK,1,0,1,0,2,0,4,50.00%,
0137.HK,0,0,0,0,2,0,2,0.00%,
0138.HK,0,0,0,0,1,0,1,0.00%,
0139.HK,0,0,1,0,2,0,3,33.33%,
0149.HK,0,0,0,0,1,0,1,0.00%,
0150.HK,1,0,0,0,0,0,1,100.00%,
0154.HK,1,1,0,0,0,0,2,100.00%,
0156.HK,0,1,0,0,3,0,4,25.00%,
0157.HK,0,1,0,1,0,0,2,50.00%,
0159.HK,0,0,0,0,4,0,4,0.00%,
0160.HK,0,0,0,0,3,0,3,0.00%,
0162.HK,0,1,0,2,1,0,4,25.00%,
0163.HK,2,0,0,0,4,0,6,33.33%,
0164.HK,0,0,0,0,3,0,3,0.00%,
0167.HK,0,0,0,0,3,0,3,0.00%,
0171.HK,3,0,0,1,0,0,4,75.00%,
0176.HK,1,0,0,0,0,0,1,100.00%,
0178.HK,1,2,0,2,2,0,7,42.86%,
0180.HK,0,0,0,0,2,0,2,0.00%,
0181.HK,1,0,0,0,1,0,2,50.00%,
0183.HK,1,0,0,0,1,0,2,50.00%,
0184.HK,1,1,0,0,0,0,2,100.00%,
0185.HK,0,0,1,2,2,0,5,20.00%,
0186.HK,1,0,0,0,1,0,2,50.00%,
0187.HK,1,1,0,0,1,0,3,66.67%,
0188.HK,0,0,0,0,2,0,2,0.00%,
0191.HK,1,0,0,0,2,0,3,33.33%,
0194.HK,1,0,0,0,1,0,2,50.00%,
0195.HK,0,0,0,0,1,1,2,0.00%,
0196.HK,0,0,0,0,1,0,1,0.00%,
0197.HK,0,0,0,2,1,0,3,0.00%,
0199.HK,1,0,0,1,3,0,5,20.00%,
0202.HK,2,1,0,0,3,0,6,50.00%,
0204.HK,0,0,0,0,1,0,1,0.00%,
0205.HK,1,0,0,1,0,0,2,50.00%,
0206.HK,1,0,0,0,1,0,2,50.00%,
0210.HK,2,0,0,0,2,0,4,50.00%,
0211.HK,0,0,0,0,0,1,1,0.00%,
0213.HK,0,0,0,1,1,0,2,0.00%,
0214.HK,0,0,1,1,0,0,2,50.00%,
0216.HK,0,0,0,0,2,0,2,0.00%,
0217.HK,0,0,0,0,1,0,1,0.00%,
0222.HK,0,1,0,1,1,0,3,33.33%,
0223.HK,1,0,0,1,1,0,3,33.33%,
0225.HK,0,0,1,0,0,0,1,100.00%,
0227.HK,0,0,0,1,3,0,4,0.00%,
0228.HK,2,0,0,0,2,0,4,50.00%,
0229.HK,0,0,0,0,2,0,2,0.00%,
0232.HK,0,0,3,0,2,1,6,50.00%,
0234.HK,0,1,0,0,1,0,2,50.00%,
0235.HK,0,0,1,1,1,0,3,33.33%,
0236.HK,0,0,0,0,0,1,1,0.00%,
0237.HK,1,0,0,0,0,0,1,100.00%,
0239.HK,0,0,0,1,0,0,1,0.00%,
0240.HK,0,0,0,0,2,0,2,0.00%,
0243.HK,3,0,1,0,1,0,5,80.00%,
0244.HK,0,1,0,0,0,0,1,100.00%,
0248.HK,0,0,1,0,1,0,2,50.00%,
0251.HK,0,0,0,1,1,0,2,0.00%,
0252.HK,0,0,0,0,0,1,1,0.00%,
0253.HK,0,0,0,0,1,0,1,0.00%,
0254.HK,1,0,1,0,1,0,3,66.67%,
0255.HK,0,0,0,0,2,0,2,0.00%,
0256.HK,0,0,0,0,3,0,3,0.00%,
0262.HK,0,0,0,1,3,0,4,0.00%,
0264.HK,0,0,1,0,1,0,2,50.00%,
0269.HK,1,1,1,0,1,2,6,50.00%,
0271.HK,0,2,0,0,2,0,4,50.00%,
0274.HK,2,0,0,1,0,0,3,66.67%,
0276.HK,1,1,0,1,3,0,6,33.33%,
0279.HK,0,0,0,0,1,0,1,0.00%,
0280.HK,1,1,0,0,2,0,4,50.00%,
0286.HK,0,0,0,0,1,0,1,0.00%,
0287.HK,0,0,0,0,0,1,1,0.00%,
0294.HK,1,0,0,0,3,0,4,25.00%,
0295.HK,0,0,1,0,1,0,2,50.00%,
0296.HK,1,0,0,0,1,0,2,50.00%,
0299.HK,1,0,0,0,3,0,4,25.00%,
0301.HK,0,1,0,0,0,0,1,100.00%,
0302.HK,1,0,0,0,2,0,3,33.33%,
0305.HK,0,0,0,0,2,1,3,0.00%,
0306.HK,1,0,0,0,3,0,4,25.00%,
0309.HK,0,0,0,0,1,0,1,0.00%,
0310.HK,0,0,0,0,2,0,2,0.00%,
0311.HK,0,0,0,0,3,0,3,0.00%,
0312.HK,0,0,0,0,1,1,2,0.00%,
0314.HK,0,1,0,0,0,0,1,100.00%,
0318.HK,0,1,0,0,0,0,1,100.00%,
0320.HK,0,0,0,1,0,0,1,0.00%,
0321.HK,6,0,1,2,0,0,9,77.78%,
0328.HK,0,0,0,1,3,0,4,0.00%,
0329.HK,2,0,0,0,2,1,5,40.00%,
0330.HK,0,0,0,1,2,0,3,0.00%,
0332.HK,2,0,0,0,1,0,3,66.67%,
0333.HK,0,0,1,1,1,1,4,25.00%,
0334.HK,0,0,1,0,3,0,4,25.00%,
0335.HK,1,0,0,0,1,1,3,33.33%,
0339.HK,0,0,0,0,1,0,1,0.00%,
0343.HK,0,1,1,0,1,1,4,50.00%,
0346.HK,1,0,0,2,2,0,5,20.00%,
0348.HK,0,0,0,0,1,0,1,0.00%,
0351.HK,0,0,1,0,1,0,2,50.00%,
0352.HK,1,0,0,1,2,0,4,25.00%,
0353.HK,0,0,0,1,1,2,4,0.00%,
0355.HK,1,0,0,2,0,0,3,33.33%,
0356.HK,1,0,0,1,0,0,2,50.00%,
0360.HK,0,1,0,1,4,0,6,16.67%,
0361.HK,2,0,1,1,2,1,7,42.86%,
0362.HK,0,0,0,0,1,0,1,0.00%,
0365.HK,2,0,0,0,2,0,4,50.00%,
0366.HK,1,0,0,0,1,0,2,50.00%,
0367.HK,0,0,1,1,0,0,2,50.00%,
0372.HK,1,0,0,0,2,0,3,33.33%,
0375.HK,0,0,1,3,1,1,6,16.67%,
0377.HK,0,0,0,1,2,0,3,0.00%,
0379.HK,0,0,0,0,3,0,3,0.00%,
0380.HK,1,0,0,1,1,0,3,33.33%,
0381.HK,0,1,0,0,1,1,3,33.33%,
0382.HK,1,0,0,0,1,0,2,50.00%,
0383.HK,0,0,0,1,1,0,2,0.00%,
0385.HK,1,0,0,0,1,0,2,50.00%,
0387.HK,0,0,0,0,1,0,1,0.00%,
0389.HK,0,0,1,0,0,2,3,33.33%,
0391.HK,1,0,0,1,3,1,6,16.67%,
0396.HK,0,0,0,1,1,0,2,0.00%,
0397.HK,0,0,0,1,3,0,4,0.00%,
0398.HK,0,0,0,0,2,0,2,0.00%,
0399.HK,0,0,0,1,3,0,4,0.00%,
0401.HK,0,0,1,0,0,0,1,100.00%,
0403.HK,0,0,0,0,1,0,1,0.00%,
0406.HK,1,0,0,0,4,0,5,20.00%,
0408.HK,2,0,0,0,1,0,3,66.67%,
0413.HK,0,0,0,1,3,0,4,0.00%,
0417.HK,1,0,0,0,1,0,2,50.00%,
0418.HK,0,1,0,0,1,0,2,50.00%,
0419.HK,1,0,0,3,2,1,7,14.29%,
0420.HK,1,0,0,2,0,0,3,33.33%,
0423.HK,0,0,0,0,0,1,1,0.00%,
0426.HK,0,0,0,0,1,0,1,0.00%,
0430.HK,0,0,1,0,0,0,1,100.00%,
0433.HK,1,1,0,0,0,0,2,100.00%,
0438.HK,0,0,0,1,0,0,1,0.00%,
0439.HK,0,0,0,0,1,0,1,0.00%,
0442.HK,0,1,0,0,1,0,2,50.00%,
0444.HK,1,0,0,0,1,0,2,50.00%,
0450.HK,0,0,0,0,2,0,2,0.00%,
0451.HK,0,0,0,0,1,0,1,0.00%,
0455.HK,1,0,2,0,2,1,6,50.00%,
0456.HK,0,1,0,1,1,0,3,33.33%,
0459.HK,0,0,0,0,1,0,1,0.00%,
0464.HK,1,0,0,1,0,1,3,33.33%,
0471.HK,1,0,0,0,3,0,4,25.00%,
0472.HK,1,0,0,1,1,0,3,33.33%,
0474.HK,0,0,0,0,2,0,2,0.00%,
0475.HK,1,0,0,1,0,0,2,50.00%,
0476.HK,0,0,0,0,2,0,2,0.00%,
0482.HK,0,0,0,0,2,0,2,0.00%,
0483.HK,0,0,1,0,4,0,5,20.00%,
0484.HK,3,0,0,0,1,1,5,60.00%,
0487.HK,2,0,0,0,0,0,2,100.00%,
0488.HK,0,0,1,0,0,0,1,100.00%,
0491.HK,0,0,0,0,2,0,2,0.00%,
0493.HK,0,0,0,2,2,0,4,0.00%,
0495.HK,1,0,0,0,0,1,2,50.00%,
0496.HK,0,0,0,0,1,0,1,0.00%,
0498.HK,2,0,0,0,4,1,7,28.57%,
0500.HK,1,1,1,0,1,0,4,75.00%,
0505.HK,0,0,0,1,0,0,1,0.00%,
0509.HK,0,0,0,0,1,0,1,0.00%,
0510.HK,1,0,0,0,1,0,2,50.00%,
0511.HK,1,0,0,0,4,0,5,20.00%,
0513.HK,1,0,0,2,2,0,5,20.00%,
0515.HK,2,0,1,1,2,0,6,50.00%,
0518.HK,0,0,0,1,3,0,4,0.00%,
0520.HK,1,0,0,0,0,1,2,50.00%,
0524.HK,0,0,0,1,3,0,4,0.00%,
0526.HK,0,0,0,1,1,0,2,0.00%,
0527.HK,0,0,1,0,3,0,4,25.00%,
0528.HK,0,0,0,0,1,1,2,0.00%,
0529.HK,0,0,0,0,1,0,1,0.00%,
0532.HK,0,0,0,1,1,0,2,0.00%,
0533.HK,2,0,0,1,2,0,5,40.00%,
0536.HK,0,0,0,0,1,0,1,0.00%,
0538.HK,2,0,1,0,0,0,3,100.00%,
0540.HK,0,0,0,1,2,1,4,0.00%,
0543.HK,1,0,0,0,1,0,2,50.00%,
0544.HK,1,0,0,0,0,0,1,100.00%,
0550.HK,1,0,0,0,0,0,1,100.00%,
0553.HK,3,0,1,0,5,1,10,40.00%,
0554.HK,0,0,2,0,0,0,2,100.00%,
0556.HK,3,0,0,0,0,0,3,100.00%,
0557.HK,0,0,0,0,2,0,2,0.00%,
0559.HK,0,1,0,1,0,0,2,50.00%,
0567.HK,1,0,0,1,2,1,5,20.00%,
0568.HK,1,0,0,1,3,0,5,20.00%,
0571.HK,1,0,0,0,3,1,5,20.00%,
0573.HK,1,0,0,0,1,0,2,50.00%,
0574.HK,0,0,0,0,1,0,1,0.00%,
0575.HK,2,0,0,1,0,1,4,50.00%,
0582.HK,0,0,0,0,3,1,4,0.00%,
0585.HK,0,0,0,0,4,0,4,0.00%,
0595.HK,0,2,0,1,2,0,5,40.00%,
0599.HK,2,0,1,0,2,0,5,60.00%,
0601.HK,0,0,0,0,2,0,2,0.00%,
0602.HK,2,0,0,1,1,0,4,50.00%,
0603.HK,1,0,0,0,2,0,3,33.33%,
0605.HK,0,1,0,0,0,0,1,100.00%,
0608.HK,1,0,1,0,0,0,2,100.00%,
0609.HK,1,0,1,1,0,0,3,66.67%,
0610.HK,0,0,0,1,0,0,1,0.00%,
0611.HK,1,0,0,1,2,0,4,25.00%,
0612.HK,1,0,0,0,0,1,2,50.00%,
0617.HK,2,1,0,1,0,0,4,75.00%,
0618.HK,0,0,0,0,2,0,2,0.00%,
0619.HK,1,0,0,2,0,0,3,33.33%,
0620.HK,4,0,2,0,0,0,6,100.00%,
0623.HK,0,0,0,1,1,0,2,0.00%,
0626.HK,2,0,0,1,3,0,6,33.33%,
0629.HK,1,1,0,0,2,0,4,50.00%,
0630.HK,0,1,0,0,2,0,3,33.33%,
0632.HK,2,0,0,0,4,1,7,28.57%,
0637.HK,0,0,0,0,1,1,2,0.00%,
0641.HK,1,0,1,0,2,0,4,50.00%,
0643.HK,1,0,0,1,1,0,3,33.33%,
0646.HK,2,0,2,0,0,0,4,100.00%,
0648.HK,0,1,0,0,1,0,2,50.00%,
0650.HK,0,0,1,0,1,0,2,50.00%,
0653.HK,1,0,0,0,2,0,3,33.33%,
0657.HK,1,0,0,0,3,1,5,20.00%,
0660.HK,0,0,0,0,2,1,3,0.00%,
0661.HK,0,0,1,0,1,0,2,50.00%,
0663.HK,1,0,0,1,0,0,2,50.00%,
0673.HK,0,0,0,2,0,0,2,0.00%,
0679.HK,3,0,0,0,1,0,4,75.00%,
0681.HK,2,0,0,1,0,0,3,66.67%,
0682.HK,0,0,0,1,1,0,2,0.00%,
0687.HK,2,0,0,0,2,0,4,50.00%,
0689.HK,0,1,0,0,0,0,1,100.00%,
0690.HK,0,0,0,1,1,0,2,0.00%,
0701.HK,1,0,1,0,2,2,6,33.33%,
0702.HK,0,0,0,1,1,1,3,0.00%,
0703.HK,3,0,0,0,1,0,4,75.00%,
0704.HK,0,1,0,1,1,0,3,33.33%,
0707.HK,0,1,0,0,4,0,5,20.00%,
0711.HK,0,0,0,0,2,0,2,0.00%,
0712.HK,0,0,0,0,4,0,4,0.00%,
0713.HK,0,0,0,1,1,0,2,0.00%,
0716.HK,2,0,0,1,2,0,5,40.00%,
0717.HK,1,0,0,0,0,0,1,100.00%,
0719.HK,0,0,0,1,2,0,3,0.00%,
0721.HK,0,0,0,1,1,0,2,0.00%,
0722.HK,1,0,0,0,0,0,1,100.00%,
0723.HK,1,0,0,1,1,0,3,33.33%,
0724.HK,4,0,0,0,0,0,4,100.00%,
0726.HK,0,0,1,0,2,0,3,33.33%,
0730.HK,0,1,0,2,4,1,8,12.50%,
0731.HK,0,0,1,0,1,0,2,50.00%,
0733.HK,1,0,0,1,2,0,4,25.00%,
0738.HK,0,0,0,0,1,0,1,0.00%,
0745.HK,1,0,1,0,2,0,4,50.00%,
0750.HK,1,0,0,1,2,0,4,25.00%,
0755.HK,2,0,0,0,3,0,5,40.00%,
0756.HK,0,0,0,1,0,0,1,0.00%,
0757.HK,1,0,0,0,2,0,3,33.33%,
0759.HK,0,0,0,0,1,0,1,0.00%,
0764.HK,0,0,1,1,4,0,6,16.67%,
0765.HK,0,1,0,0,2,1,4,25.00%,
0767.HK,0,0,0,0,0,1,1,0.00%,
0768.HK,0,0,0,0,2,0,2,0.00%,
0769.HK,0,0,0,0,2,0,2,0.00%,
0770.HK,0,0,1,0,2,0,3,33.33%,
0776.HK,0,0,0,0,0,1,1,0.00%,
0784.HK,0,0,0,0,1,0,1,0.00%,
0798.HK,1,0,0,0,1,0,2,50.00%,
0802.HK,0,0,0,1,0,0,1,0.00%,
0809.HK,2,0,2,0,1,0,5,80.00%,
0810.HK,0,1,1,0,4,0,6,33.33%,
0814.HK,1,0,3,0,0,0,4,100.00%,
0815.HK,1,0,0,0,1,0,2,50.00%,
0818.HK,0,0,0,0,5,0,5,0.00%,
0821.HK,0,0,0,0,2,0,2,0.00%,
0822.HK,0,0,0,1,0,0,1,0.00%,
0825.HK,2,0,1,0,5,0,8,37.50%,
0827.HK,2,0,1,1,2,0,6,50.00%,
0828.HK,1,0,0,1,1,0,3,33.33%,
0829.HK,1,1,1,1,1,0,5,60.00%,
0831.HK,0,0,0,0,1,1,2,0.00%,
0833.HK,1,0,0,1,1,0,3,33.33%,
0834.HK,1,0,0,0,0,0,1,100.00%,
0840.HK,2,0,0,0,1,0,3,66.67%,
0841.HK,1,0,0,1,1,0,3,33.33%,
0844.HK,0,0,0,0,2,0,2,0.00%,
0848.HK,2,0,0,2,2,1,7,28.57%,
0851.HK,0,1,1,0,1,0,3,66.67%,
0852.HK,0,2,0,0,2,0,4,50.00%,
0854.HK,0,1,0,0,0,0,1,100.00%,
0858.HK,1,0,0,0,2,0,3,33.33%,
0859.HK,0,0,0,0,1,1,2,0.00%,
0860.HK,1,1,0,0,1,0,3,66.67%,
0862.HK,0,0,0,0,2,0,2,0.00%,
0869.HK,1,0,0,0,2,0,3,33.33%,
0871.HK,0,0,0,0,1,0,1,0.00%,
0873.HK,0,0,0,1,1,0,2,0.00%,
0875.HK,1,0,2,0,0,0,3,100.00%,
0876.HK,1,1,0,0,0,0,2,100.00%,
0888.HK,0,1,0,0,1,0,2,50.00%,
0893.HK,2,0,0,0,1,0,3,66.67%,
0894.HK,0,0,0,2,2,0,4,0.00%,
0895.HK,2,0,0,0,0,0,2,100.00%,
0896.HK,0,0,0,0,2,0,2,0.00%,
0897.HK,0,0,0,1,2,1,4,0.00%,
0899.HK,0,0,0,1,1,1,3,0.00%,
0905.HK,2,0,0,1,1,1,5,40.00%,
0907.HK,0,0,0,0,1,0,1,0.00%,
0911.HK,1,0,0,0,3,0,4,25.00%,
0912.HK,1,0,0,0,2,0,3,33.33%,
0913.HK,1,0,0,0,1,0,2,50.00%,
0915.HK,0,0,2,1,2,0,5,40.00%,
0918.HK,0,1,1,0,2,0,4,50.00%,
0919.HK,0,0,0,1,2,1,4,0.00%,
0922.HK,0,0,0,0,2,2,4,0.00%,
0923.HK,0,0,1,0,1,0,2,50.00%,
0926.HK,2,1,0,0,1,0,4,75.00%,
0927.HK,2,0,0,0,1,0,3,66.67%,
0928.HK,1,0,0,0,5,0,6,16.67%,
0929.HK,1,1,0,0,0,0,2,100.00%,
0932.HK,0,0,0,0,2,0,2,0.00%,
0936.HK,2,0,0,1,0,0,3,66.67%,
0943.HK,0,0,1,0,3,0,4,25.00%,
0948.HK,1,0,0,0,1,0,2,50.00%,
0950.HK,0,0,0,0,4,0,4,0.00%,
0951.HK,2,0,0,1,1,0,4,50.00%,
0952.HK,1,0,1,1,1,0,4,50.00%,
0953.HK,0,0,0,1,2,0,3,0.00%,
0954.HK,1,0,0,0,0,0,1,100.00%,
0959.HK,0,0,0,1,0,0,1,0.00%,
0969.HK,0,0,0,1,1,1,3,0.00%,
0970.HK,1,0,0,0,3,0,4,25.00%,
0976.HK,1,0,0,0,3,0,4,25.00%,
0979.HK,0,0,0,1,0,1,2,0.00%,
0980.HK,1,0,1,0,5,1,8,25.00%,
0983.HK,0,0,1,1,2,0,4,25.00%,
0984.HK,0,0,0,0,1,1,2,0.00%,
0986.HK,0,0,0,1,3,0,4,0.00%,
0987.HK,0,1,0,0,1,1,3,33.33%,
0993.HK,0,0,1,1,0,0,2,50.00%,
0994.HK,2,0,1,0,1,1,5,60.00%,
1000.HK,2,0,0,1,0,0,3,66.67%,
1001.HK,0,0,0,1,1,0,2,0.00%,
1002.HK,0,0,0,0,3,0,3,0.00%,
1003.HK,0,1,1,2,1,0,5,40.00%,
1004.HK,0,0,0,1,1,0,2,0.00%,
1005.HK,0,1,1,0,2,0,4,50.00%,
1007.HK,0,0,0,0,1,0,1,0.00%,
1008.HK,0,0,0,0,1,0,1,0.00%,
1009.HK,0,0,0,0,1,0,1,0.00%,
1010.HK,1,0,0,0,0,0,1,100.00%,
1011.HK,1,0,0,0,0,0,1,100.00%,
1013.HK,1,0,0,0,1,0,2,50.00%,
1020.HK,0,0,0,0,3,0,3,0.00%,
1022.HK,1,0,0,0,1,0,2,50.00%,
1023.HK,0,0,0,0,1,0,1,0.00%,
1025.HK,0,0,0,0,1,0,1,0.00%,
1026.HK,0,0,0,0,1,1,2,0.00%,
1027.HK,0,0,0,0,1,0,1,0.00%,
1028.HK,0,0,0,0,1,1,2,0.00%,
1029.HK,0,0,0,0,2,0,2,0.00%,
1037.HK,0,0,0,0,1,0,1,0.00%,
1039.HK,0,1,0,0,2,0,3,33.33%,
1045.HK,0,0,0,1,5,0,6,0.00%,
1046.HK,1,1,1,0,3,0,6,50.00%,
1047.HK,0,1,1,0,1,0,3,66.67%,
1049.HK,1,0,1,1,2,1,6,33.33%,
1053.HK,0,1,0,1,2,0,4,25.00%,
1057.HK,1,1,1,0,1,1,5,60.00%,
1058.HK,0,0,0,0,3,0,3,0.00%,
1059.HK,1,0,0,0,3,0,4,25.00%,
1062.HK,1,0,0,1,2,0,4,25.00%,
1063.HK,2,0,0,0,2,0,4,50.00%,
1065.HK,2,0,0,1,4,0,7,28.57%,
1068.HK,2,0,1,0,3,0,6,50.00%,
1069.HK,1,0,1,1,0,0,3,66.67%,
1073.HK,2,0,0,0,1,1,4,50.00%,
1075.HK,0,0,0,0,1,0,1,0.00%,
1079.HK,0,1,1,0,3,0,5,40.00%,
1082.HK,0,0,0,1,1,0,2,0.00%,
1084.HK,0,0,0,0,1,0,1,0.00%,
1085.HK,1,0,1,0,1,0,3,66.67%,
1087.HK,0,0,0,0,1,0,1,0.00%,
1090.HK,0,0,0,0,2,0,2,0.00%,
1094.HK,1,0,1,0,3,0,5,40.00%,
1097.HK,0,0,0,3,3,0,6,0.00%,
1098.HK,1,0,0,0,1,0,2,50.00%,
1100.HK,2,0,1,1,1,1,6,50.00%,
1101.HK,1,0,1,0,1,0,3,66.67%,
1102.HK,0,0,1,0,1,0,2,50.00%,
1105.HK,1,0,0,0,0,0,1,100.00%,
1108.HK,2,1,1,0,5,0,9,44.44%,
1110.HK,0,0,1,1,2,0,4,25.00%,
1118.HK,1,0,1,0,0,0,2,100.00%,
1119.HK,1,0,0,3,0,0,4,25.00%,
1120.HK,0,0,0,0,1,0,1,0.00%,
1122.HK,1,0,0,0,1,0,2,50.00%,
1127.HK,0,0,0,0,1,0,1,0.00%,
1129.HK,0,1,0,2,1,0,4,25.00%,
1130.HK,0,0,1,0,3,0,4,25.00%,
1132.HK,1,0,0,0,1,0,2,50.00%,
1134.HK,1,0,0,0,1,0,2,50.00%,
1137.HK,0,0,1,2,4,0,7,14.29%,
1141.HK,0,0,0,2,5,0,7,0.00%,
1143.HK,1,0,0,1,1,0,3,33.33%,
1145.HK,1,0,0,0,0,0,1,100.00%,
1146.HK,0,0,0,0,1,0,1,0.00%,
1148.HK,1,0,0,0,1,0,2,50.00%,
1150.HK,1,0,0,0,2,1,4,25.00%,
1152.HK,0,0,1,0,0,1,2,50.00%,
1153.HK,0,0,0,0,1,0,1,0.00%,
1159.HK,0,0,0,0,5,2,7,0.00%,
1163.HK,0,0,0,0,1,0,1,0.00%,
1165.HK,1,0,0,0,4,0,5,20.00%,
1166.HK,0,0,0,0,1,0,1,0.00%,
1170.HK,1,0,0,0,2,0,3,33.33%,
1172.HK,0,0,1,1,3,0,5,20.00%,
1173.HK,0,0,0,0,1,0,1,0.00%,
1180.HK,1,0,1,0,1,0,3,66.67%,
1181.HK,2,0,0,1,0,0,3,66.67%,
1183.HK,0,0,0,0,2,0,2,0.00%,
1185.HK,1,0,0,0,0,0,1,100.00%,
1188.HK,1,0,0,0,1,0,2,50.00%,
1195.HK,0,0,0,0,1,1,2,0.00%,
1198.HK,0,0,0,0,3,0,3,0.00%,
1200.HK,4,1,0,0,2,0,7,71.43%,
1201.HK,1,0,1,2,3,1,8,25.00%,
1202.HK,3,1,1,0,3,1,9,55.56%,
1203.HK,0,0,0,0,0,1,1,0.00%,
1206.HK,0,0,0,0,1,0,1,0.00%,
1215.HK,0,0,0,0,1,0,1,0.00%,
1217.HK,1,0,0,0,0,0,1,100.00%,
1220.HK,0,0,0,1,1,0,2,0.00%,
1221.HK,1,0,0,0,1,1,3,33.33%,
1222.HK,0,0,0,0,1,0,1,0.00%,
1225.HK,1,0,1,0,0,0,2,100.00%,
1229.HK,0,0,0,0,2,1,3,0.00%,
1235.HK,0,0,0,0,1,0,1,0.00%,
1237.HK,0,0,0,0,3,0,3,0.00%,
1239.HK,0,1,1,0,0,0,2,100.00%,
1240.HK,0,0,0,1,0,0,1,0.00%,
1241.HK,0,0,2,0,0,1,3,66.67%,
1244.HK,0,0,0,0,1,0,1,0.00%,
1247.HK,0,0,0,0,2,1,3,0.00%,
1251.HK,4,0,1,0,4,0,9,55.56%,
1252.HK,0,0,0,2,2,0,4,0.00%,
1253.HK,2,0,0,1,2,0,5,40.00%,
1255.HK,0,0,0,0,2,0,2,0.00%,
1257.HK,0,0,0,1,3,0,4,0.00%,
1259.HK,0,0,0,0,1,0,1,0.00%,
1260.HK,0,0,0,0,2,0,2,0.00%,
1262.HK,0,0,2,0,0,0,2,100.00%,
1265.HK,2,0,0,0,0,0,2,100.00%,
1269.HK,2,0,0,0,0,0,2,100.00%,
1273.HK,0,0,0,0,2,0,2,0.00%,
1281.HK,1,0,0,0,1,0,2,50.00%,
1282.HK,1,0,0,0,2,1,4,25.00%,
1285.HK,0,0,0,0,0,1,1,0.00%,
1289.HK,0,0,0,0,1,0,1,0.00%,
1292.HK,0,0,3,1,1,1,6,50.00%,
1293.HK,1,0,0,0,1,0,2,50.00%,
1298.HK,0,0,0,0,1,0,1,0.00%,
1301.HK,1,0,0,0,1,0,2,50.00%,
1303.HK,0,0,1,0,0,0,1,100.00%,
1305.HK,1,1,0,0,0,0,2,100.00%,
1312.HK,0,0,1,1,1,0,3,33.33%,
1314.HK,0,0,0,0,2,0,2,0.00%,
1315.HK,1,0,0,0,2,0,3,33.33%,
1317.HK,1,0,0,0,0,0,1,100.00%,
1319.HK,0,0,0,0,1,0,1,0.00%,
1323.HK,0,0,0,0,2,0,2,0.00%,
1326.HK,0,0,0,0,1,0,1,0.00%,
1327.HK,0,0,1,0,0,0,1,100.00%,
1328.HK,1,0,0,0,0,0,1,100.00%,
1332.HK,0,0,1,1,1,1,4,25.00%,
1335.HK,0,0,0,0,0,1,1,0.00%,
1338.HK,0,0,0,1,1,0,2,0.00%,
1348.HK,0,0,0,0,1,0,1,0.00%,
1349.HK,1,0,1,2,5,0,9,22.22%,
1351.HK,0,0,0,0,0,1,1,0.00%,
1355.HK,1,0,0,0,1,0,2,50.00%,
1362.HK,0,2,0,1,0,0,3,66.67%,
1370.HK,0,0,0,0,1,0,1,0.00%,
1371.HK,1,0,0,2,0,0,3,33.33%,
1372.HK,1,1,0,0,3,1,6,33.33%,
1380.HK,0,0,0,0,1,1,2,0.00%,
1388.HK,2,0,0,0,1,0,3,66.67%,
1389.HK,1,1,0,0,1,0,3,66.67%,
1393.HK,0,0,0,0,1,1,2,0.00%,
1397.HK,0,0,0,1,1,0,2,0.00%,
1399.HK,0,0,1,1,1,0,3,33.33%,
1400.HK,0,0,0,0,3,0,3,0.00%,
1402.HK,1,0,0,0,0,0,1,100.00%,
1408.HK,0,0,0,0,1,0,1,0.00%,
1410.HK,0,0,0,0,1,0,1,0.00%,
1413.HK,0,0,0,0,1,1,2,0.00%,
1416.HK,0,0,1,0,0,0,1,100.00%,
1419.HK,1,0,0,0,2,0,3,33.33%,
1420.HK,0,0,0,0,2,0,2,0.00%,
1421.HK,0,1,0,0,0,0,1,100.00%,
1427.HK,0,0,0,0,1,0,1,0.00%,
1429.HK,1,0,0,0,0,0,1,100.00%,
1431.HK,0,0,0,1,3,0,4,0.00%,
1442.HK,0,0,0,0,1,0,1,0.00%,
1443.HK,0,0,1,0,0,0,1,100.00%,
1447.HK,0,1,0,0,0,0,1,100.00%,
1451.HK,0,1,0,0,0,0,1,100.00%,
1459.HK,0,0,0,0,1,0,1,0.00%,
1463.HK,0,2,0,0,1,0,3,66.67%,
1468.HK,0,0,0,1,0,0,1,0.00%,
1470.HK,1,0,0,0,0,1,2,50.00%,
1472.HK,0,0,0,0,1,0,1,0.00%,
1473.HK,0,0,0,0,1,1,2,0.00%,
1476.HK,2,1,0,0,0,0,3,100.00%,
1480.HK,2,0,0,0,1,0,3,66.67%,
1483.HK,2,0,0,0,0,0,2,100.00%,
1488.HK,2,0,0,0,1,0,3,66.67%,
1496.HK,1,0,0,0,0,0,1,100.00%,
1498.HK,0,1,0,0,0,0,1,100.00%,
1520.HK,0,1,0,0,2,0,3,33.33%,
1522.HK,0,0,0,0,2,0,2,0.00%,
1526.HK,1,1,1,0,0,0,3,100.00%,
1527.HK,0,0,0,0,1,0,1,0.00%,
1529.HK,1,0,1,0,0,0,2,100.00%,
1536.HK,0,0,0,0,0,1,1,0.00%,
1538.HK,0,1,0,0,2,0,3,33.33%,
1539.HK,0,0,0,0,3,0,3,0.00%,
1540.HK,1,0,0,0,0,0,1,100.00%,
1542.HK,0,0,0,0,0,1,1,0.00%,
1543.HK,0,0,0,0,2,0,2,0.00%,
1545.HK,1,0,0,0,1,1,3,33.33%,
1549.HK,0,1,1,0,0,0,2,100.00%,
1555.HK,0,0,0,0,1,0,1,0.00%,
1557.HK,0,0,1,0,1,1,3,33.33%,
1559.HK,0,0,0,0,2,1,3,0.00%,
1561.HK,0,0,1,0,0,1,2,50.00%,
1563.HK,0,0,0,0,1,0,1,0.00%,
1565.HK,1,0,0,1,1,0,3,33.33%,
1566.HK,0,0,0,2,2,0,4,0.00%,
1569.HK,0,0,0,2,1,0,3,0.00%,
1572.HK,0,0,0,0,0,1,1,0.00%,
1581.HK,0,0,1,0,0,0,1,100.00%,
1583.HK,0,0,0,0,2,0,2,0.00%,
1586.HK,2,0,0,0,0,0,2,100.00%,
1587.HK,0,0,0,0,1,0,1,0.00%,
1588.HK,2,1,0,0,2,0,5,60.00%,
1593.HK,0,0,0,1,0,0,1,0.00%,
1596.HK,0,1,0,0,2,0,3,33.33%,
1597.HK,0,0,0,1,0,0,1,0.00%,
1599.HK,0,0,1,0,0,0,1,100.00%,
1601.HK,0,0,0,0,1,0,1,0.00%,
1608.HK,0,0,0,1,3,0,4,0.00%,
1613.HK,0,0,0,0,1,0,1,0.00%,
1616.HK,0,0,0,0,1,0,1,0.00%,
1617.HK,0,0,0,0,4,0,4,0.00%,
1620.HK,0,0,0,0,1,0,1,0.00%,
1621.HK,0,0,0,0,1,0,1,0.00%,
1623.HK,0,0,0,0,1,0,1,0.00%,
1626.HK,2,0,0,1,3,0,6,33.33%,
1632.HK,0,0,0,0,1,1,2,0.00%,
1636.HK,0,0,0,0,2,0,2,0.00%,
1652.HK,1,0,0,0,0,0,1,100.00%,
1653.HK,0,0,0,0,1,0,1,0.00%,
1655.HK,1,0,0,1,0,0,2,50.00%,
1656.HK,0,0,0,0,1,0,1,0.00%,
1657.HK,0,0,0,0,0,1,1,0.00%,
1661.HK,2,0,0,0,1,1,4,50.00%,
1662.HK,0,0,0,0,1,0,1,0.00%,
1669.HK,0,1,0,0,3,0,4,25.00%,
1671.HK,0,0,0,1,1,0,2,0.00%,
1673.HK,0,0,0,0,2,0,2,0.00%,
1676.HK,0,0,0,0,2,0,2,0.00%,
1679.HK,0,0,0,0,1,0,1,0.00%,
1680.HK,0,0,0,1,3,0,4,0.00%,
1682.HK,0,0,0,0,0,1,1,0.00%,
1685.HK,1,0,1,1,1,0,4,50.00%,
1689.HK,0,0,0,0,1,0,1,0.00%,
1692.HK,0,0,0,2,0,0,2,0.00%,
1697.HK,0,0,1,0,1,0,2,50.00%,
1701.HK,0,0,0,0,0,1,1,0.00%,
1710.HK,0,0,0,0,3,0,3,0.00%,
1711.HK,0,0,0,0,3,1,4,0.00%,
1713.HK,0,0,0,0,1,0,1,0.00%,
1715.HK,0,0,0,0,2,0,2,0.00%,
1716.HK,1,0,0,0,0,0,1,100.00%,
1718.HK,0,0,0,0,2,0,2,0.00%,
1719.HK,1,0,0,0,0,1,2,50.00%,
1720.HK,0,0,0,0,1,0,1,0.00%,
1723.HK,1,0,0,0,1,0,2,50.00%,
1725.HK,0,1,0,0,1,0,2,50.00%,
1728.HK,0,0,0,2,1,0,3,0.00%,
1731.HK,0,0,0,1,0,1,2,0.00%,
1732.HK,0,0,0,0,2,0,2,0.00%,
1736.HK,0,0,0,0,3,0,3,0.00%,
1737.HK,0,0,0,0,1,0,1,0.00%,
1738.HK,1,0,0,0,0,0,1,100.00%,
1739.HK,0,0,0,0,3,0,3,0.00%,
1740.HK,0,0,0,0,2,1,3,0.00%,
1745.HK,0,0,0,0,1,0,1,0.00%,
1752.HK,0,0,0,1,0,0,1,0.00%,
1753.HK,0,0,0,0,0,1,1,0.00%,
1760.HK,1,0,0,0,0,0,1,100.00%,
1762.HK,0,0,1,0,0,0,1,100.00%,
1763.HK,1,0,0,0,1,1,3,33.33%,
1765.HK,0,0,0,0,1,0,1,0.00%,
1769.HK,1,0,0,0,1,0,2,50.00%,
1771.HK,0,0,0,0,1,0,1,0.00%,
1775.HK,0,1,0,0,0,0,1,100.00%,
1778.HK,2,0,0,0,1,0,3,66.67%,
1785.HK,1,1,0,0,1,0,3,66.67%,
1786.HK,0,0,0,0,1,0,1,0.00%,
1792.HK,0,0,0,1,0,0,1,0.00%,
1795.HK,0,0,0,0,1,0,1,0.00%,
1803.HK,0,0,0,1,4,0,5,0.00%,
1808.HK,0,0,0,0,2,0,2,0.00%,
1812.HK,3,0,0,0,3,0,6,50.00%,
1817.HK,1,0,0,0,0,0,1,100.00%,
1822.HK,1,0,0,0,0,0,1,100.00%,
1823.HK,0,0,0,0,0,1,1,0.00%,
1826.HK,0,0,0,0,1,0,1,0.00%,
1827.HK,0,0,0,0,1,0,1,0.00%,
1830.HK,1,0,1,0,0,0,2,100.00%,
1831.HK,0,0,0,0,3,0,3,0.00%,
1841.HK,0,0,0,0,1,0,1,0.00%,
1842.HK,0,0,2,0,1,0,3,66.67%,
1846.HK,0,0,0,0,1,0,1,0.00%,
1849.HK,0,0,0,0,1,0,1,0.00%,
1851.HK,0,0,0,0,1,0,1,0.00%,
1854.HK,0,0,0,1,0,0,1,0.00%,
1858.HK,0,0,0,0,1,0,1,0.00%,
1861.HK,1,0,0,0,1,0,2,50.00%,
1868.HK,1,0,1,0,1,0,3,66.67%,
1869.HK,0,0,0,1,1,0,2,0.00%,
1871.HK,0,0,1,1,1,0,3,33.33%,
1875.HK,0,0,0,0,1,0,1,0.00%,
1878.HK,0,0,0,0,3,0,3,0.00%,
1884.HK,1,0,0,0,1,0,2,50.00%,
1889.HK,0,0,0,1,0,0,1,0.00%,
1891.HK,0,0,1,0,1,0,2,50.00%,
1895.HK,0,0,0,0,1,0,1,0.00%,
1900.HK,0,0,0,0,1,0,1,0.00%,
1906.HK,1,0,0,0,1,0,2,50.00%,
1909.HK,0,0,0,0,2,0,2,0.00%,
1915.HK,0,0,0,0,1,0,1,0.00%,
1916.HK,0,0,0,1,0,0,1,0.00%,
1917.HK,1,0,1,0,2,0,4,50.00%,
1930.HK,0,0,0,0,0,1,1,0.00%,
1933.HK,0,0,0,0,0,1,1,0.00%,
1935.HK,1,1,0,0,0,0,2,100.00%,
1937.HK,0,0,0,1,0,1,2,0.00%,
1941.HK,0,0,0,0,2,0,2,0.00%,
1942.HK,0,0,1,0,1,0,2,50.00%,
1945.HK,2,0,0,0,1,0,3,66.67%,
1949.HK,0,0,0,0,0,1,1,0.00%,
1950.HK,2,0,0,1,0,0,3,66.67%,
1959.HK,0,0,1,0,0,0,1,100.00%,
1960.HK,0,0,0,0,1,0,1,0.00%,
1961.HK,0,0,0,0,1,0,1,0.00%,
1962.HK,0,0,0,0,1,0,1,0.00%,
1967.HK,0,0,0,0,1,0,1,0.00%,
1968.HK,0,0,0,0,0,1,1,0.00%,
1971.HK,0,1,0,0,0,0,1,100.00%,
1975.HK,1,1,1,0,0,0,3,100.00%,
1980.HK,0,0,0,0,1,0,1,0.00%,
1986.HK,1,0,0,0,0,0,1,100.00%,
1987.HK,0,0,0,0,1,0,1,0.00%,
1991.HK,0,0,0,0,0,2,2,0.00%,
1993.HK,0,0,0,0,2,0,2,0.00%,
2000.HK,1,0,0,1,0,0,2,50.00%,
2002.HK,1,0,0,0,1,0,2,50.00%,
2008.HK,2,1,0,0,5,0,8,37.50%,
2009.HK,1,0,0,0,2,0,3,33.33%,
2012.HK,0,0,0,1,1,0,2,0.00%,
2022.HK,0,0,0,0,1,0,1,0.00%,
2023.HK,1,0,1,0,1,0,3,66.67%,
2028.HK,1,0,0,0,2,0,3,33.33%,
2031.HK,1,0,0,0,1,0,2,50.00%,
2033.HK,1,0,0,0,0,0,1,100.00%,
2051.HK,0,0,0,1,2,0,3,0.00%,
2060.HK,0,0,0,1,1,0,2,0.00%,
2098.HK,4,0,0,0,2,0,6,66.67%,
2100.HK,0,0,0,0,1,0,1,0.00%,
2101.HK,0,0,0,0,2,0,2,0.00%,
2102.HK,0,0,0,0,1,0,1,0.00%,
2108.HK,0,0,0,1,0,0,1,0.00%,
2112.HK,0,0,0,0,2,0,2,0.00%,
2119.HK,0,0,0,0,1,1,2,0.00%,
2120.HK,0,0,0,1,1,0,2,0.00%,
2127.HK,0,0,0,0,1,0,1,0.00%,
2131.HK,0,0,0,0,1,0,1,0.00%,
2135.HK,0,0,0,0,1,0,1,0.00%,
2136.HK,0,0,0,0,2,0,2,0.00%,
2137.HK,0,0,0,0,1,0,1,0.00%,
2138.HK,0,0,0,1,1,0,2,0.00%,
2139.HK,0,0,0,0,1,0,1,0.00%,
2150.HK,1,0,0,0,1,0,2,50.00%,
2159.HK,1,0,0,0,0,0,1,100.00%,
2163.HK,0,0,0,0,2,0,2,0.00%,
2166.HK,0,0,0,0,1,0,1,0.00%,
2170.HK,1,0,1,0,0,0,2,100.00%,
2175.HK,0,0,0,0,1,0,1,0.00%,
2176.HK,1,0,0,1,0,0,2,50.00%,
2177.HK,0,0,0,0,1,0,1,0.00%,
2178.HK,1,0,1,0,0,0,2,100.00%,
2185.HK,0,1,0,0,2,0,3,33.33%,
2187.HK,0,0,0,0,1,0,1,0.00%,
2188.HK,0,0,0,1,0,0,1,0.00%,
2203.HK,0,1,0,0,0,1,2,50.00%,
2211.HK,1,0,0,0,1,0,2,50.00%,
2212.HK,1,0,0,1,0,0,2,50.00%,
2216.HK,0,0,0,0,1,0,1,0.00%,
2218.HK,2,0,0,1,1,0,4,50.00%,
2219.HK,0,0,0,0,1,0,1,0.00%,
2222.HK,0,0,0,0,1,1,2,0.00%,
2223.HK,0,0,0,1,1,0,2,0.00%,
2226.HK,1,0,0,0,0,0,1,100.00%,
2230.HK,0,0,0,1,1,0,2,0.00%,
2246.HK,0,0,1,0,0,0,1,100.00%,
2257.HK,0,0,0,1,0,0,1,0.00%,
2260.HK,3,0,0,0,0,0,3,100.00%,
2265.HK,0,0,0,0,1,0,1,0.00%,
2280.HK,0,0,0,2,1,1,4,0.00%,
2289.HK,1,0,0,0,0,0,1,100.00%,
2297.HK,0,0,0,0,1,0,1,0.00%,
2307.HK,0,0,0,1,1,0,2,0.00%,
2312.HK,0,0,0,0,1,0,1,0.00%,
2320.HK,1,0,0,0,0,0,1,100.00%,
2322.HK,1,0,0,0,1,1,3,33.33%,
2323.HK,1,0,1,0,1,0,3,66.67%,
2326.HK,0,0,0,0,1,0,1,0.00%,
2327.HK,0,0,0,0,0,1,1,0.00%,
2336.HK,0,0,0,0,1,0,1,0.00%,
2337.HK,0,0,0,1,1,0,2,0.00%,
2339.HK,0,0,0,0,4,0,4,0.00%,
2348.HK,0,0,1,0,3,0,4,25.00%,
2349.HK,0,0,0,2,0,0,2,0.00%,
2358.HK,0,0,0,0,1,0,1,0.00%,
2369.HK,0,0,0,0,3,0,3,0.00%,
2371.HK,0,0,0,0,3,0,3,0.00%,
2383.HK,2,0,0,1,1,0,4,50.00%,
2392.HK,0,0,0,0,1,0,1,0.00%,
2393.HK,0,0,0,1,0,0,1,0.00%,
2399.HK,2,0,0,0,4,0,6,33.33%,
2405.HK,0,0,0,1,0,0,1,0.00%,
2416.HK,0,0,1,0,2,0,3,33.33%,
2422.HK,0,0,0,0,0,1,1,0.00%,
2425.HK,0,0,0,0,1,0,1,0.00%,
2436.HK,0,0,0,0,1,0,1,0.00%,
2438.HK,0,0,0,0,1,0,1,0.00%,
2439.HK,0,0,0,0,1,0,1,0.00%,
2488.HK,1,0,0,0,3,0,4,25.00%,
2495.HK,0,0,1,0,0,0,1,100.00%,
2500.HK,0,0,0,1,2,0,3,0.00%,
2502.HK,0,0,0,0,1,0,1,0.00%,
2516.HK,0,0,0,0,2,0,2,0.00%,
2560.HK,0,0,0,0,1,0,1,0.00%,
2563.HK,0,0,0,1,0,0,1,0.00%,
2625.HK,0,0,0,0,1,0,1,0.00%,
2683.HK,1,0,0,0,0,0,1,100.00%,
2722.HK,0,0,2,0,1,0,3,66.67%,
2728.HK,0,0,0,0,2,0,2,0.00%,
2738.HK,0,0,0,0,0,1,1,0.00%,
2779.HK,0,0,0,1,0,0,1,0.00%,
2798.HK,0,0,0,0,1,0,1,0.00%,
2878.HK,1,0,1,0,3,0,5,40.00%,
2882.HK,0,1,0,0,0,1,2,50.00%,
2886.HK,0,0,0,1,0,0,1,0.00%,
3300.HK,0,0,0,1,2,0,3,0.00%,
3303.HK,1,0,0,1,3,1,6,16.67%,
3313.HK,0,0,0,0,3,0,3,0.00%,
3318.HK,2,0,1,0,1,0,4,75.00%,
3322.HK,1,0,0,0,2,0,3,33.33%,
3332.HK,1,0,0,0,1,0,2,50.00%,
3348.HK,1,0,0,0,0,0,1,100.00%,
3368.HK,3,0,0,0,4,0,7,42.86%,
3389.HK,2,0,0,0,1,0,3,66.67%,
3390.HK,0,0,0,0,1,0,1,0.00%,
3395.HK,1,0,0,0,0,0,1,100.00%,
3399.HK,0,0,0,1,4,0,5,0.00%,
3626.HK,0,0,0,0,0,1,1,0.00%,
3638.HK,0,0,0,1,1,0,2,0.00%,
3666.HK,0,0,0,1,1,0,2,0.00%,
3683.HK,1,0,1,0,1,0,3,66.67%,
3768.HK,1,0,0,0,0,0,1,100.00%,
3773.HK,0,0,0,0,2,0,2,0.00%,
3816.HK,1,0,0,0,0,0,1,100.00%,
3828.HK,0,0,0,0,1,1,2,0.00%,
3836.HK,0,0,0,0,4,0,4,0.00%,
3838.HK,0,0,1,0,1,0,2,50.00%,
3882.HK,2,0,0,0,0,0,2,100.00%,
3889.HK,1,0,0,0,2,0,3,33.33%,
3893.HK,0,0,0,0,1,0,1,0.00%,
3919.HK,0,0,0,0,1,0,1,0.00%,
3991.HK,1,0,0,0,1,1,3,33.33%,
3999.HK,0,0,0,1,1,0,2,0.00%,
6033.HK,0,0,0,0,2,0,2,0.00%,
6083.HK,1,0,0,0,2,0,3,33.33%,
6100.HK,0,0,0,1,0,0,1,0.00%,
6123.HK,1,0,1,0,1,0,3,66.67%,
6133.HK,0,0,0,0,1,0,1,0.00%,
6136.HK,0,1,0,0,0,0,1,100.00%,
6162.HK,0,0,0,1,0,0,1,0.00%,
6689.HK,0,0,0,1,0,0,1,0.00%,
6698.HK,0,0,0,1,0,0,1,0.00%,
6812.HK,2,0,0,0,0,0,2,100.00%,
6820.HK,0,1,0,0,0,0,1,100.00%,
6826.HK,0,0,0,1,1,0,2,0.00%,
6828.HK,0,0,0,0,1,0,1,0.00%,
6830.HK,0,0,0,2,1,0,3,0.00%,
6838.HK,0,1,0,0,1,0,2,50.00%,
6839.HK,1,0,0,0,1,0,2,50.00%,
6858.HK,1,0,0,0,0,0,1,100.00%,
6860.HK,0,0,0,0,1,0,1,0.00%,
6877.HK,0,0,1,0,1,0,2,50.00%,
6878.HK,0,0,0,0,1,0,1,0.00%,
6882.HK,0,0,0,0,3,0,3,0.00%,
6885.HK,0,0,1,0,1,0,2,50.00%,
6890.HK,0,0,0,1,0,0,1,0.00%,
6898.HK,1,0,0,0,1,0,2,50.00%,
6899.HK,0,0,0,1,0,0,1,0.00%,
6908.HK,0,0,0,0,1,0,1,0.00%,
6909.HK,0,0,0,0,1,0,1,0.00%,
6911.HK,0,0,0,0,0,1,1,0.00%,
6918.HK,0,0,0,0,0,1,1,0.00%,
6919.HK,0,0,0,0,1,0,1,0.00%,
6922.HK,1,0,0,0,0,0,1,100.00%,
6928.HK,0,0,0,0,1,0,1,0.00%,
6933.HK,0,0,0,0,1,0,1,0.00%,
6988.HK,1,0,0,0,0,0,1,100.00%,
8005.HK,2,0,1,3,1,0,7,42.86%,
8006.HK,0,1,1,1,0,1,4,50.00%,
8007.HK,0,0,1,0,2,0,3,33.33%,
8017.HK,0,0,0,1,0,0,1,0.00%,
8020.HK,0,0,0,0,1,0,1,0.00%,
8026.HK,1,0,1,0,1,0,3,66.67%,
8028.HK,3,0,0,0,5,1,9,33.33%,
8029.HK,3,0,0,0,1,0,4,75.00%,
8031.HK,0,0,0,1,0,0,1,0.00%,
8033.HK,1,0,1,0,0,0,2,100.00%,
8036.HK,0,0,0,0,1,0,1,0.00%,
8041.HK,0,0,0,0,3,0,3,0.00%,
8042.HK,0,0,0,0,1,0,1,0.00%,
8043.HK,0,0,0,1,0,0,1,0.00%,
8047.HK,0,1,0,1,2,0,4,25.00%,
8048.HK,0,0,0,0,1,0,1,0.00%,
8050.HK,1,0,0,0,2,0,3,33.33%,
8052.HK,0,0,0,0,2,0,2,0.00%,
8060.HK,0,1,0,0,1,0,2,50.00%,
8063.HK,0,1,1,0,0,0,2,100.00%,
8069.HK,0,0,0,0,1,0,1,0.00%,
8071.HK,1,0,0,0,0,0,1,100.00%,
8072.HK,1,0,0,0,0,0,1,100.00%,
8079.HK,0,0,1,0,1,0,2,50.00%,
8081.HK,0,0,0,1,0,0,1,0.00%,
8082.HK,0,0,0,0,2,0,2,0.00%,
8087.HK,1,0,0,1,0,0,2,50.00%,
8092.HK,0,0,1,0,0,0,1,100.00%,
8095.HK,2,0,0,0,1,1,4,50.00%,
8096.HK,0,0,0,1,0,0,1,0.00%,
8103.HK,0,0,0,1,0,0,1,0.00%,
8111.HK,0,0,0,0,1,0,1,0.00%,
8117.HK,0,0,0,0,2,1,3,0.00%,
8118.HK,1,0,0,0,1,0,2,50.00%,
8120.HK,1,0,0,1,1,0,3,33.33%,
8126.HK,0,0,0,1,0,0,1,0.00%,
8128.HK,0,0,0,1,3,0,4,0.00%,
8130.HK,1,0,0,1,3,0,5,20.00%,
8132.HK,1,0,0,0,1,0,2,50.00%,
8133.HK,0,0,1,0,0,0,1,100.00%,
8136.HK,1,0,0,0,0,0,1,100.00%,
8139.HK,1,0,0,0,0,0,1,100.00%,
8147.HK,1,0,0,0,0,2,3,33.33%,
8156.HK,1,0,0,0,2,1,4,25.00%,
8162.HK,0,0,0,0,1,0,1,0.00%,
8168.HK,0,0,0,1,1,0,2,0.00%,
8169.HK,1,0,0,0,0,0,1,100.00%,
8172.HK,1,1,0,0,2,1,5,40.00%,
8178.HK,1,1,0,1,1,1,5,40.00%,
8179.HK,1,0,0,1,1,0,3,33.33%,
8186.HK,0,0,0,0,1,0,1,0.00%,
8187.HK,0,0,0,0,0,1,1,0.00%,
8189.HK,0,0,0,0,1,0,1,0.00%,
8191.HK,0,0,0,0,0,1,1,0.00%,
8193.HK,0,0,0,0,1,0,1,0.00%,
8196.HK,0,0,0,0,1,2,3,0.00%,
8200.HK,2,0,0,1,0,1,4,50.00%,
8203.HK,1,0,0,1,1,0,3,33.33%,
8219.HK,0,0,1,0,1,1,3,33.33%,
8222.HK,1,0,1,0,0,0,2,100.00%,
8223.HK,0,0,1,0,0,0,1,100.00%,
8227.HK,0,0,1,0,0,0,1,100.00%,
8237.HK,0,0,0,0,1,0,1,0.00%,
8245.HK,0,0,0,0,0,1,1,0.00%,
8246.HK,0,0,1,0,0,0,1,100.00%,
8250.HK,0,0,0,2,0,0,2,0.00%,
8257.HK,0,0,0,0,1,0,1,0.00%,
8267.HK,1,0,0,0,1,0,2,50.00%,
8270.HK,0,0,0,0,1,0,1,0.00%,
8282.HK,0,0,0,0,1,0,1,0.00%,
8283.HK,0,0,0,0,1,0,1,0.00%,
8286.HK,0,0,0,0,0,2,2,0.00%,
8292.HK,1,0,0,0,0,0,1,100.00%,
8293.HK,0,1,0,1,0,1,3,33.33%,
8295.HK,0,1,0,0,0,1,2,50.00%,
8296.HK,0,0,1,0,1,1,3,33.33%,
8309.HK,0,0,0,0,1,1,2,0.00%,
8310.HK,0,0,0,0,1,0,1,0.00%,
8313.HK,0,0,0,0,1,0,1,0.00%,
8317.HK,0,1,0,1,1,0,3,33.33%,
8320.HK,0,2,0,0,1,0,3,66.67%,
8326.HK,1,0,0,0,0,0,1,100.00%,
8328.HK,1,0,0,0,3,0,4,25.00%,
8337.HK,0,0,0,0,1,0,1,0.00%,
8340.HK,1,0,0,0,0,0,1,100.00%,
8347.HK,1,0,0,1,0,0,2,50.00%,
8348.HK,1,0,0,0,0,0,1,100.00%,
8365.HK,0,0,0,0,2,0,2,0.00%,
8367.HK,0,0,0,1,0,0,1,0.00%,
8372.HK,0,0,0,0,2,0,2,0.00%,
8379.HK,0,0,0,0,1,1,2,0.00%,
8385.HK,0,0,1,0,0,0,1,100.00%,
8391.HK,0,0,0,0,0,1,1,0.00%,
8395.HK,0,0,0,0,0,2,2,0.00%,
8403.HK,1,0,0,0,3,2,6,16.67%,
8413.HK,0,0,0,0,1,0,1,0.00%,
8416.HK,0,0,0,0,3,0,3,0.00%,
8418.HK,0,0,0,0,1,0,1,0.00%,
8450.HK,0,1,0,0,0,0,1,100.00%,
8452.HK,0,0,0,0,1,1,2,0.00%,
8456.HK,0,0,0,0,1,0,1,0.00%,
8472.HK,0,0,0,0,1,1,2,0.00%,
8473.HK,0,0,0,0,0,1,1,0.00%,
8476.HK,1,0,0,0,0,0,1,100.00%,
8481.HK,0,0,0,1,0,0,1,0.00%,
8482.HK,0,0,0,1,1,0,2,0.00%,
8483.HK,0,0,0,0,1,0,1,0.00%,
8489.HK,0,1,0,1,0,1,3,33.33%,
8490.HK,0,0,0,1,0,2,3,0.00%,
8502.HK,0,0,0,0,1,0,1,0.00%,
8525.HK,0,0,0,0,1,0,1,0.00%,
8529.HK,0,1,0,0,0,0,1,100.00%,
8536.HK,0,0,0,0,3,0,3,0.00%,
8537.HK,0,0,0,0,1,0,1,0.00%,
8545.HK,0,0,0,0,1,0,1,0.00%,
8547.HK,0,0,0,0,2,0,2,0.00%,
8613.HK,0,0,0,1,0,0,1,0.00%,
8620.HK,0,0,1,0,0,0,1,100.00%,
8646.HK,1,1,0,0,0,0,2,100.00%,
8657.HK,0,0,1,0,0,1,2,50.00%,
8659.HK,1,0,0,0,1,0,2,50.00%,
9990.HK,1,0,0,0,0,0,1,100.00%,
9991.HK,0,0,0,0,2,0,2,0.00%,
,488,119,192,307,1211,177,2494,32.04%,91
