sno,TP12,TP1,TP2,TP1C,CL1,BY1,,,
0007.HK,1,1,0,0,3,2,7,28.57%,
0009.HK,0,0,0,0,3,0,3,0.00%,
0018.HK,0,0,0,0,0,1,1,0.00%,
0021.HK,0,1,1,0,5,1,8,25.00%,
0022.HK,0,0,0,0,1,1,2,0.00%,
0025.HK,0,0,0,0,1,0,1,0.00%,
0030.HK,1,0,1,1,1,0,4,50.00%,
0031.HK,1,0,0,0,0,0,1,100.00%,
0033.HK,1,0,0,0,3,0,4,25.00%,
0036.HK,0,0,0,1,2,1,4,0.00%,
0037.HK,3,0,1,1,3,0,8,50.00%,
0039.HK,1,1,0,0,0,1,3,66.67%,
0040.HK,1,0,0,0,1,0,2,50.00%,
0042.HK,1,0,0,0,5,1,7,14.29%,
0046.HK,2,0,0,1,2,0,5,40.00%,
0048.HK,0,1,0,0,2,1,4,25.00%,
0050.HK,0,0,0,0,2,0,2,0.00%,
0052.HK,1,0,0,0,2,0,3,33.33%,
0055.HK,2,0,0,0,1,1,4,50.00%,
0057.HK,2,0,1,1,3,1,8,37.50%,
0058.HK,0,1,0,0,3,0,4,25.00%,
0059.HK,1,1,0,1,1,0,4,50.00%,
0060.HK,0,0,0,1,0,4,5,0.00%,
0061.HK,1,0,0,1,1,1,4,25.00%,
0063.HK,1,0,1,1,2,1,6,33.33%,
0064.HK,0,0,2,0,2,0,4,50.00%,
0065.HK,2,0,0,1,1,0,4,50.00%,
0070.HK,1,0,0,0,2,3,6,16.67%,
0072.HK,0,0,0,0,1,2,3,0.00%,
0073.HK,0,0,0,0,1,1,2,0.00%,
0075.HK,1,0,0,0,1,1,3,33.33%,
0076.HK,3,0,0,1,1,0,5,60.00%,
0077.HK,2,0,0,0,0,0,2,100.00%,
0078.HK,2,0,0,0,4,4,10,20.00%,
0079.HK,0,1,1,0,1,2,5,40.00%,
0080.HK,0,1,0,0,0,1,2,50.00%,
0082.HK,0,0,1,1,3,3,8,12.50%,
0084.HK,0,1,0,1,2,1,5,20.00%,
0088.HK,2,0,0,0,3,0,5,40.00%,
0089.HK,1,0,0,0,4,0,5,20.00%,
0090.HK,1,0,0,0,0,0,1,100.00%,
0092.HK,1,0,0,1,2,0,4,25.00%,
0093.HK,0,2,0,1,1,1,5,40.00%,
0094.HK,0,1,1,0,1,1,4,50.00%,
0095.HK,1,0,1,0,1,0,3,66.67%,
0096.HK,1,0,0,0,0,0,1,100.00%,
0097.HK,2,2,0,0,1,1,6,66.67%,
0099.HK,1,1,0,0,2,1,5,40.00%,
0104.HK,2,0,0,1,2,1,6,33.33%,
0105.HK,0,0,0,0,0,1,1,0.00%,
0106.HK,1,0,0,0,2,2,5,20.00%,
0110.HK,0,1,0,0,2,1,4,25.00%,
0111.HK,4,0,0,1,2,3,10,40.00%,
0114.HK,1,0,0,0,0,0,1,100.00%,
0115.HK,0,0,0,1,1,0,2,0.00%,
0118.HK,2,0,0,1,2,0,5,40.00%,
0120.HK,0,0,1,0,4,1,6,16.67%,
0122.HK,1,0,0,0,1,0,2,50.00%,
0124.HK,2,0,1,0,2,0,5,60.00%,
0125.HK,2,0,0,0,0,0,2,100.00%,
0126.HK,0,1,0,1,2,2,6,16.67%,
0128.HK,1,0,0,0,0,0,1,100.00%,
0129.HK,1,0,0,1,0,0,2,50.00%,
0130.HK,0,0,0,0,3,0,3,0.00%,
0131.HK,1,2,0,0,2,0,5,60.00%,
0132.HK,0,0,0,1,1,0,2,0.00%,
0137.HK,1,0,0,0,2,0,3,33.33%,
0138.HK,0,1,0,1,0,0,2,50.00%,
0139.HK,0,0,2,0,0,0,2,100.00%,
0145.HK,1,0,1,0,1,0,3,66.67%,
0146.HK,1,0,0,0,0,0,1,100.00%,
0149.HK,0,1,0,0,1,0,2,50.00%,
0150.HK,1,0,0,0,0,0,1,100.00%,
0154.HK,0,1,1,0,1,0,3,66.67%,
0156.HK,2,0,1,0,2,2,7,42.86%,
0157.HK,3,2,0,0,1,0,6,83.33%,
0159.HK,0,1,0,0,2,0,3,33.33%,
0160.HK,2,0,1,0,2,0,5,60.00%,
0162.HK,0,1,0,0,5,3,9,11.11%,
0163.HK,1,0,0,1,2,0,4,25.00%,
0164.HK,0,0,1,0,3,1,5,20.00%,
0166.HK,0,1,0,0,0,2,3,33.33%,
0167.HK,3,1,0,0,0,1,5,80.00%,
0171.HK,1,0,1,0,2,1,5,40.00%,
0174.HK,0,1,0,1,1,1,4,25.00%,
0176.HK,1,0,0,0,1,0,2,50.00%,
0178.HK,4,1,0,1,3,0,9,55.56%,
0181.HK,0,0,0,0,1,1,2,0.00%,
0183.HK,0,0,0,0,1,0,1,0.00%,
0184.HK,0,0,0,0,1,2,3,0.00%,
0185.HK,1,0,0,0,2,2,5,20.00%,
0186.HK,1,0,0,0,1,0,2,50.00%,
0187.HK,2,0,0,2,3,0,7,28.57%,
0188.HK,0,0,0,1,2,1,4,0.00%,
0191.HK,0,0,0,0,1,0,1,0.00%,
0193.HK,2,0,0,0,3,0,5,40.00%,
0194.HK,1,0,0,0,4,1,6,16.67%,
0195.HK,0,0,0,0,2,0,2,0.00%,
0196.HK,0,0,0,0,4,1,5,0.00%,
0197.HK,3,1,0,0,2,1,7,57.14%,
0199.HK,0,2,0,0,4,1,7,28.57%,
0201.HK,1,0,1,0,1,0,3,66.67%,
0202.HK,0,2,0,0,3,1,6,33.33%,
0204.HK,0,0,0,0,3,1,4,0.00%,
0205.HK,1,0,0,0,4,0,5,20.00%,
0206.HK,1,0,0,0,3,0,4,25.00%,
0209.HK,1,1,0,0,1,1,4,50.00%,
0210.HK,0,0,0,1,2,1,4,0.00%,
0211.HK,0,0,0,0,2,1,3,0.00%,
0212.HK,0,0,0,0,1,0,1,0.00%,
0213.HK,0,1,0,0,2,1,4,25.00%,
0214.HK,1,0,0,2,1,0,4,25.00%,
0216.HK,0,1,0,0,0,0,1,100.00%,
0217.HK,2,1,1,0,1,0,5,80.00%,
0222.HK,0,2,1,0,1,0,4,75.00%,
0223.HK,1,0,1,0,1,3,6,33.33%,
0224.HK,0,0,0,0,1,0,1,0.00%,
0225.HK,0,0,1,0,1,0,2,50.00%,
0227.HK,3,1,0,0,2,1,7,57.14%,
0228.HK,2,0,0,0,3,0,5,40.00%,
0229.HK,0,0,0,0,2,0,2,0.00%,
0232.HK,2,0,0,2,5,0,9,22.22%,
0234.HK,2,1,0,1,1,0,5,60.00%,
0235.HK,1,1,0,1,2,2,7,28.57%,
0236.HK,0,1,0,1,1,1,4,25.00%,
0237.HK,0,0,0,0,0,1,1,0.00%,
0239.HK,2,0,0,0,0,0,2,100.00%,
0240.HK,0,1,0,0,2,1,4,25.00%,
0243.HK,2,1,0,2,2,0,7,42.86%,
0244.HK,1,0,1,0,1,2,5,40.00%,
0248.HK,0,0,2,0,0,1,3,66.67%,
0251.HK,4,0,0,0,0,0,4,100.00%,
0252.HK,0,0,0,0,0,1,1,0.00%,
0253.HK,0,0,0,0,1,0,1,0.00%,
0254.HK,1,1,0,1,0,0,3,66.67%,
0255.HK,0,0,1,1,3,1,6,16.67%,
0256.HK,0,0,0,0,4,2,6,0.00%,
0261.HK,0,1,0,0,0,0,1,100.00%,
0262.HK,1,0,0,0,3,0,4,25.00%,
0264.HK,0,0,2,0,3,0,5,40.00%,
0265.HK,2,0,0,0,2,1,5,40.00%,
0266.HK,1,0,0,0,0,0,1,100.00%,
0269.HK,1,1,0,0,3,2,7,28.57%,
0271.HK,1,0,0,0,2,0,3,33.33%,
0274.HK,1,0,1,0,0,0,2,100.00%,
0276.HK,1,0,0,0,3,0,4,25.00%,
0279.HK,0,0,1,0,3,0,4,25.00%,
0280.HK,1,2,1,3,1,1,9,44.44%,
0286.HK,2,0,0,0,3,1,6,33.33%,
0287.HK,0,1,0,0,0,0,1,100.00%,
0294.HK,2,0,0,0,0,1,3,66.67%,
0295.HK,2,0,1,1,1,0,5,60.00%,
0296.HK,0,0,0,0,1,0,1,0.00%,
0298.HK,1,0,0,0,3,0,4,25.00%,
0299.HK,0,1,0,0,3,0,4,25.00%,
0301.HK,0,0,0,0,1,0,1,0.00%,
0302.HK,0,0,0,0,1,0,1,0.00%,
0305.HK,1,1,0,0,1,1,4,50.00%,
0306.HK,0,0,0,1,1,0,2,0.00%,
0309.HK,2,1,0,0,2,2,7,42.86%,
0310.HK,0,0,0,0,3,0,3,0.00%,
0311.HK,1,1,1,0,1,0,4,75.00%,
0312.HK,1,0,0,0,1,1,3,33.33%,
0318.HK,0,2,1,0,3,1,7,42.86%,
0321.HK,2,1,0,0,2,1,6,50.00%,
0328.HK,1,1,0,1,0,0,3,66.67%,
0329.HK,0,0,0,1,4,0,5,0.00%,
0330.HK,2,0,0,1,2,0,5,40.00%,
0332.HK,6,0,0,0,2,0,8,75.00%,
0333.HK,1,0,0,1,1,0,3,33.33%,
0334.HK,0,0,0,1,2,1,4,0.00%,
0335.HK,1,0,0,0,1,1,3,33.33%,
0339.HK,0,0,0,0,0,1,1,0.00%,
0343.HK,0,1,0,0,4,3,8,12.50%,
0346.HK,2,0,0,0,1,1,4,50.00%,
0348.HK,0,0,0,0,1,0,1,0.00%,
0351.HK,0,1,1,0,2,0,4,50.00%,
0352.HK,0,0,2,0,1,0,3,66.67%,
0353.HK,1,0,0,0,1,2,4,25.00%,
0355.HK,1,0,0,0,3,2,6,16.67%,
0356.HK,0,0,0,1,0,0,1,0.00%,
0360.HK,0,0,0,0,1,1,2,0.00%,
0361.HK,0,0,0,0,6,2,8,0.00%,
0362.HK,1,0,0,1,3,1,6,16.67%,
0365.HK,1,0,0,0,2,1,4,25.00%,
0366.HK,1,1,1,1,2,0,6,50.00%,
0367.HK,1,0,0,2,1,0,4,25.00%,
0368.HK,0,0,0,1,0,0,1,0.00%,
0372.HK,2,1,0,0,0,1,4,75.00%,
0375.HK,0,0,0,1,0,2,3,0.00%,
0377.HK,0,0,1,0,3,2,6,16.67%,
0379.HK,1,0,0,0,4,2,7,14.29%,
0380.HK,0,0,1,0,0,0,1,100.00%,
0381.HK,0,1,0,1,1,0,3,33.33%,
0382.HK,0,0,0,0,1,0,1,0.00%,
0383.HK,0,0,1,0,2,1,4,25.00%,
0387.HK,0,1,0,0,0,1,2,50.00%,
0389.HK,0,0,0,0,4,1,5,0.00%,
0391.HK,1,0,0,1,1,0,3,33.33%,
0396.HK,1,0,0,0,1,0,2,50.00%,
0397.HK,0,0,0,2,0,1,3,0.00%,
0398.HK,0,0,0,3,2,0,5,0.00%,
0399.HK,0,0,1,1,2,0,4,25.00%,
0401.HK,0,0,0,0,2,1,3,0.00%,
0403.HK,0,0,0,0,2,0,2,0.00%,
0406.HK,0,0,0,0,3,0,3,0.00%,
0408.HK,2,0,1,0,3,1,7,42.86%,
0413.HK,1,1,0,0,1,0,3,66.67%,
0417.HK,0,0,1,0,2,0,3,33.33%,
0418.HK,1,1,0,1,4,0,7,28.57%,
0419.HK,1,2,1,1,1,2,8,50.00%,
0420.HK,0,0,0,1,3,0,4,0.00%,
0422.HK,0,1,1,0,1,1,4,50.00%,
0423.HK,1,0,0,0,0,0,1,100.00%,
0426.HK,0,0,0,0,3,0,3,0.00%,
0428.HK,0,0,1,0,2,1,4,25.00%,
0430.HK,1,2,0,1,2,1,7,42.86%,
0432.HK,0,0,0,1,1,1,3,0.00%,
0433.HK,0,1,0,2,3,1,7,14.29%,
0436.HK,0,0,0,0,1,0,1,0.00%,
0438.HK,0,1,0,0,1,0,2,50.00%,
0439.HK,1,0,0,0,1,0,2,50.00%,
0442.HK,0,0,0,0,1,1,2,0.00%,
0444.HK,5,0,0,1,2,0,8,62.50%,
0450.HK,1,0,0,0,2,0,3,33.33%,
0451.HK,1,0,0,0,2,4,7,14.29%,
0455.HK,0,0,0,0,4,1,5,0.00%,
0456.HK,0,0,0,0,1,0,1,0.00%,
0458.HK,1,0,0,0,0,0,1,100.00%,
0464.HK,0,0,0,1,0,1,2,0.00%,
0465.HK,1,0,0,0,0,0,1,100.00%,
0471.HK,1,0,0,2,5,2,10,10.00%,
0472.HK,1,0,0,0,2,1,4,25.00%,
0474.HK,3,1,0,0,6,0,10,40.00%,
0475.HK,2,0,0,1,0,2,5,40.00%,
0476.HK,1,0,0,1,2,3,7,14.29%,
0482.HK,0,0,0,0,2,0,2,0.00%,
0483.HK,2,0,0,0,5,0,7,28.57%,
0484.HK,0,0,1,0,1,2,4,25.00%,
0487.HK,0,0,2,0,4,2,8,25.00%,
0488.HK,1,0,0,0,3,0,4,25.00%,
0491.HK,0,0,0,1,4,0,5,0.00%,
0493.HK,1,0,1,1,1,0,4,50.00%,
0495.HK,0,0,0,0,1,0,1,0.00%,
0496.HK,0,1,0,2,6,0,9,11.11%,
0498.HK,1,1,0,0,3,0,5,40.00%,
0500.HK,4,0,0,0,4,0,8,50.00%,
0509.HK,0,0,0,1,1,0,2,0.00%,
0510.HK,0,0,0,0,3,0,3,0.00%,
0511.HK,2,0,0,1,4,1,8,25.00%,
0513.HK,1,0,0,0,2,1,4,25.00%,
0515.HK,0,3,0,0,3,1,7,42.86%,
0518.HK,0,0,0,0,0,1,1,0.00%,
0520.HK,1,0,0,0,2,1,4,25.00%,
0524.HK,0,0,0,0,2,0,2,0.00%,
0526.HK,2,0,0,1,3,0,6,33.33%,
0527.HK,0,1,1,0,2,1,5,40.00%,
0528.HK,0,0,0,0,1,1,2,0.00%,
0529.HK,0,0,0,0,2,0,2,0.00%,
0532.HK,1,0,0,0,0,0,1,100.00%,
0533.HK,0,1,0,1,2,0,4,25.00%,
0536.HK,0,1,1,0,1,0,3,66.67%,
0538.HK,0,1,0,1,3,0,5,20.00%,
0540.HK,0,0,2,0,2,1,5,40.00%,
0543.HK,1,0,0,0,2,2,5,20.00%,
0544.HK,0,0,0,1,2,1,4,0.00%,
0550.HK,0,0,0,0,6,0,6,0.00%,
0553.HK,1,1,1,3,2,2,10,30.00%,
0554.HK,1,0,0,0,0,0,1,100.00%,
0556.HK,1,0,0,0,3,0,4,25.00%,
0557.HK,0,2,0,0,1,2,5,40.00%,
0559.HK,0,0,0,1,4,1,6,0.00%,
0560.HK,2,0,0,0,1,1,4,50.00%,
0567.HK,0,0,0,0,3,3,6,0.00%,
0568.HK,2,0,0,1,2,2,7,28.57%,
0571.HK,1,1,1,0,0,1,4,75.00%,
0573.HK,0,0,0,0,1,0,1,0.00%,
0574.HK,1,0,0,0,2,2,5,20.00%,
0575.HK,1,0,0,0,3,1,5,20.00%,
0582.HK,2,0,0,0,5,0,7,28.57%,
0585.HK,1,0,2,0,1,0,4,75.00%,
0587.HK,0,0,0,0,4,0,4,0.00%,
0591.HK,0,0,0,0,2,1,3,0.00%,
0595.HK,2,0,0,0,6,1,9,22.22%,
0599.HK,0,0,0,0,1,0,1,0.00%,
0601.HK,0,1,0,0,0,0,1,100.00%,
0602.HK,0,0,0,1,1,0,2,0.00%,
0603.HK,2,0,0,0,2,1,5,40.00%,
0605.HK,0,2,0,0,2,2,6,33.33%,
0606.HK,0,0,0,0,1,0,1,0.00%,
0608.HK,0,0,0,0,1,0,1,0.00%,
0609.HK,0,1,0,0,1,0,2,50.00%,
0610.HK,0,1,0,0,0,0,1,100.00%,
0611.HK,1,2,0,0,0,0,3,100.00%,
0612.HK,3,0,0,1,1,1,6,50.00%,
0613.HK,1,0,0,0,2,0,3,33.33%,
0617.HK,2,0,1,0,0,0,3,100.00%,
0618.HK,0,0,0,0,1,1,2,0.00%,
0619.HK,0,0,0,0,2,1,3,0.00%,
0620.HK,1,0,0,0,0,0,1,100.00%,
0621.HK,1,1,0,0,3,1,6,33.33%,
0623.HK,1,0,0,0,1,0,2,50.00%,
0626.HK,1,0,1,1,2,0,5,40.00%,
0628.HK,0,0,0,2,1,0,3,0.00%,
0629.HK,0,0,1,1,1,0,3,33.33%,
0630.HK,0,1,1,2,1,0,5,40.00%,
0632.HK,4,0,1,1,1,1,8,62.50%,
0635.HK,2,0,0,1,1,0,4,50.00%,
0637.HK,1,0,0,0,2,0,3,33.33%,
0641.HK,0,0,0,0,4,0,4,0.00%,
0643.HK,1,1,0,0,4,0,6,33.33%,
0646.HK,0,0,0,0,0,4,4,0.00%,
0648.HK,3,1,0,0,2,1,7,57.14%,
0650.HK,2,0,2,0,5,1,10,40.00%,
0653.HK,1,0,1,0,3,0,5,40.00%,
0657.HK,0,0,0,0,0,1,1,0.00%,
0660.HK,0,0,0,0,3,0,3,0.00%,
0661.HK,1,1,1,0,3,1,7,42.86%,
0663.HK,1,1,1,0,2,0,5,60.00%,
0673.HK,0,1,1,2,6,0,10,20.00%,
0675.HK,1,0,0,1,1,1,4,25.00%,
0677.HK,0,0,0,0,1,0,1,0.00%,
0679.HK,2,1,0,0,0,0,3,100.00%,
0681.HK,0,0,0,0,2,1,3,0.00%,
0682.HK,2,0,0,0,2,0,4,50.00%,
0684.HK,0,0,0,0,0,1,1,0.00%,
0685.HK,1,1,0,0,0,1,3,66.67%,
0687.HK,0,0,0,1,0,0,1,0.00%,
0689.HK,0,2,0,2,3,1,8,25.00%,
0690.HK,1,1,0,1,3,1,7,28.57%,
0701.HK,3,0,0,0,4,0,7,42.86%,
0702.HK,0,0,0,0,4,1,5,0.00%,
0703.HK,1,0,0,0,5,0,6,16.67%,
0704.HK,1,0,0,0,2,2,5,20.00%,
0707.HK,2,0,0,1,5,0,8,25.00%,
0708.HK,2,0,0,0,2,0,4,50.00%,
0711.HK,1,0,0,0,0,0,1,100.00%,
0712.HK,2,0,0,3,4,0,9,22.22%,
0713.HK,1,0,0,1,1,0,3,33.33%,
0716.HK,2,1,0,2,4,1,10,30.00%,
0717.HK,1,0,0,0,1,1,3,33.33%,
0719.HK,0,0,0,0,2,2,4,0.00%,
0721.HK,1,0,0,1,3,1,6,16.67%,
0722.HK,0,0,0,1,0,1,2,0.00%,
0723.HK,0,0,0,1,2,2,5,0.00%,
0724.HK,0,0,0,1,2,2,5,0.00%,
0726.HK,0,0,0,0,5,2,7,0.00%,
0730.HK,2,0,0,3,5,1,11,18.18%,
0731.HK,0,0,0,0,2,1,3,0.00%,
0733.HK,4,0,0,0,2,0,6,66.67%,
0736.HK,0,0,0,0,1,0,1,0.00%,
0738.HK,0,0,1,2,1,0,4,25.00%,
0750.HK,0,1,0,2,3,2,8,12.50%,
0755.HK,1,1,1,1,1,1,6,50.00%,
0756.HK,0,0,0,0,1,0,1,0.00%,
0757.HK,2,0,0,1,2,0,5,40.00%,
0759.HK,0,0,0,1,5,3,9,0.00%,
0764.HK,0,1,1,0,3,3,8,25.00%,
0765.HK,3,1,0,0,5,1,10,40.00%,
0767.HK,1,0,0,1,4,1,7,14.29%,
0768.HK,1,0,0,0,2,0,3,33.33%,
0769.HK,2,0,0,2,0,0,4,50.00%,
0771.HK,1,0,0,0,1,1,3,33.33%,
0776.HK,0,0,1,1,0,0,2,50.00%,
0784.HK,0,0,0,0,0,1,1,0.00%,
0789.HK,2,0,0,0,5,1,8,25.00%,
0794.HK,0,1,0,1,2,0,4,25.00%,
0798.HK,0,0,0,0,1,0,1,0.00%,
0802.HK,1,0,0,0,1,0,2,50.00%,
0804.HK,0,0,0,0,1,0,1,0.00%,
0809.HK,2,1,0,1,1,2,7,42.86%,
0810.HK,0,1,0,1,1,0,3,33.33%,
0814.HK,1,0,0,2,3,0,6,16.67%,
0815.HK,1,0,0,0,1,1,3,33.33%,
0818.HK,1,0,0,1,1,2,5,20.00%,
0821.HK,0,0,1,0,3,1,5,20.00%,
0822.HK,0,0,0,1,0,0,1,0.00%,
0825.HK,2,0,0,1,5,0,8,25.00%,
0827.HK,1,0,0,0,2,0,3,33.33%,
0828.HK,1,1,0,0,0,0,2,100.00%,
0829.HK,0,1,1,0,2,0,4,50.00%,
0831.HK,0,0,1,0,2,1,4,25.00%,
0833.HK,0,0,0,0,3,1,4,0.00%,
0834.HK,1,1,0,0,2,0,4,50.00%,
0840.HK,2,0,0,0,3,0,5,40.00%,
0841.HK,0,1,0,0,0,0,1,100.00%,
0844.HK,0,0,0,0,1,0,1,0.00%,
0848.HK,1,0,1,1,2,1,6,33.33%,
0851.HK,0,0,0,1,2,1,4,0.00%,
0852.HK,0,1,1,0,0,0,2,100.00%,
0854.HK,0,2,0,0,0,0,2,100.00%,
0858.HK,1,1,0,1,2,1,6,33.33%,
0859.HK,1,1,0,0,0,0,2,100.00%,
0860.HK,1,1,0,2,0,0,4,50.00%,
0862.HK,3,2,0,0,2,0,7,71.43%,
0869.HK,1,0,0,0,3,0,4,25.00%,
0871.HK,2,0,0,0,0,0,2,100.00%,
0873.HK,1,0,0,1,1,0,3,33.33%,
0875.HK,1,0,1,0,2,0,4,50.00%,
0876.HK,0,0,0,0,1,0,1,0.00%,
0888.HK,1,1,0,2,2,1,7,28.57%,
0889.HK,2,0,0,0,0,0,2,100.00%,
0893.HK,0,0,0,2,0,0,2,0.00%,
0894.HK,3,0,0,0,3,1,7,42.86%,
0895.HK,1,1,0,0,5,0,7,28.57%,
0896.HK,2,0,0,0,0,0,2,100.00%,
0897.HK,0,0,0,0,1,1,2,0.00%,
0899.HK,1,0,1,0,2,1,5,40.00%,
0905.HK,0,0,0,0,3,1,4,0.00%,
0907.HK,3,0,1,0,1,2,7,57.14%,
0911.HK,1,0,0,0,1,0,2,50.00%,
0912.HK,0,0,1,0,1,0,2,50.00%,
0913.HK,0,0,0,1,4,2,7,0.00%,
0915.HK,0,1,0,3,2,2,8,12.50%,
0918.HK,1,1,1,1,4,0,8,37.50%,
0919.HK,1,1,1,0,1,2,6,50.00%,
0922.HK,0,0,0,0,3,0,3,0.00%,
0923.HK,0,0,2,0,2,1,5,40.00%,
0926.HK,2,1,1,0,3,0,7,57.14%,
0927.HK,1,0,0,0,2,0,3,33.33%,
0928.HK,2,1,0,0,7,1,11,27.27%,
0929.HK,0,0,1,1,2,0,4,25.00%,
0932.HK,0,0,0,2,3,0,5,0.00%,
0936.HK,0,0,0,1,1,0,2,0.00%,
0943.HK,0,0,1,1,1,0,3,33.33%,
0947.HK,2,0,0,1,1,0,4,50.00%,
0948.HK,1,0,0,0,0,1,2,50.00%,
0950.HK,1,0,2,0,2,0,5,60.00%,
0951.HK,2,0,0,1,3,1,7,28.57%,
0952.HK,0,0,0,0,2,1,3,0.00%,
0953.HK,0,1,0,0,2,2,5,20.00%,
0954.HK,2,1,0,0,1,0,4,75.00%,
0959.HK,0,1,1,3,3,1,9,22.22%,
0969.HK,0,0,0,1,2,1,4,0.00%,
0970.HK,1,0,0,0,6,1,8,12.50%,
0974.HK,0,0,0,0,0,1,1,0.00%,
0976.HK,2,0,0,1,0,0,3,66.67%,
0979.HK,0,1,0,0,1,1,3,33.33%,
0980.HK,2,1,0,1,2,1,7,42.86%,
0983.HK,1,0,0,2,5,1,9,11.11%,
0984.HK,0,0,0,0,2,2,4,0.00%,
0986.HK,0,0,0,0,3,0,3,0.00%,
0987.HK,4,0,1,0,2,0,7,71.43%,
0993.HK,2,0,0,1,2,0,5,40.00%,
0994.HK,0,1,0,0,0,1,2,50.00%,
1000.HK,0,0,0,2,2,0,4,0.00%,
1001.HK,0,1,0,0,2,1,4,25.00%,
1002.HK,0,0,0,0,4,1,5,0.00%,
1003.HK,1,1,0,1,2,2,7,28.57%,
1004.HK,1,1,0,0,3,0,5,40.00%,
1005.HK,1,2,0,0,1,0,4,75.00%,
1007.HK,0,0,0,0,1,0,1,0.00%,
1008.HK,1,0,0,1,1,2,5,20.00%,
1009.HK,0,1,0,0,3,2,6,16.67%,
1010.HK,0,0,0,0,2,0,2,0.00%,
1011.HK,3,0,0,0,2,1,6,50.00%,
1013.HK,1,0,0,0,0,1,2,50.00%,
1020.HK,0,1,0,0,1,2,4,25.00%,
1022.HK,1,0,0,0,3,0,4,25.00%,
1023.HK,0,0,0,0,4,0,4,0.00%,
1025.HK,1,0,0,1,0,1,3,33.33%,
1026.HK,2,0,0,1,1,1,5,40.00%,
1028.HK,0,0,0,1,1,2,4,0.00%,
1029.HK,1,0,0,0,2,0,3,33.33%,
1037.HK,0,0,0,0,2,0,2,0.00%,
1039.HK,1,0,0,0,3,0,4,25.00%,
1045.HK,1,0,0,0,3,1,5,20.00%,
1046.HK,1,0,0,0,5,1,7,14.29%,
1049.HK,1,0,0,0,4,0,5,20.00%,
1053.HK,1,0,1,0,1,1,4,50.00%,
1057.HK,1,1,0,0,0,1,3,66.67%,
1058.HK,2,0,2,0,2,0,6,66.67%,
1059.HK,1,1,0,0,1,1,4,50.00%,
1062.HK,0,0,0,1,3,1,5,0.00%,
1063.HK,1,0,0,0,3,2,6,16.67%,
1065.HK,2,0,0,2,5,0,9,22.22%,
1068.HK,4,0,2,1,3,0,10,60.00%,
1069.HK,0,0,0,2,1,3,6,0.00%,
1073.HK,1,0,0,0,1,0,2,50.00%,
1075.HK,2,0,0,0,2,2,6,33.33%,
1079.HK,1,0,0,1,2,4,8,12.50%,
1080.HK,1,0,0,1,3,1,6,16.67%,
1082.HK,0,0,0,1,2,0,3,0.00%,
1084.HK,1,0,0,1,0,0,2,50.00%,
1085.HK,0,1,0,0,2,1,4,25.00%,
1087.HK,2,1,0,0,2,0,5,60.00%,
1090.HK,1,0,0,0,1,0,2,50.00%,
1094.HK,0,0,0,0,1,1,2,0.00%,
1097.HK,0,0,1,2,0,1,4,25.00%,
1098.HK,1,1,0,1,4,2,9,22.22%,
1100.HK,1,1,1,0,3,0,6,50.00%,
1101.HK,2,0,0,0,1,0,3,66.67%,
1102.HK,3,0,0,0,0,0,3,100.00%,
1105.HK,0,0,0,0,1,2,3,0.00%,
1108.HK,1,1,0,0,3,0,5,40.00%,
1110.HK,0,1,0,0,3,2,6,16.67%,
1116.HK,0,0,0,0,1,0,1,0.00%,
1118.HK,0,0,0,0,3,2,5,0.00%,
1119.HK,3,0,0,1,3,1,8,37.50%,
1120.HK,0,0,0,0,1,0,1,0.00%,
1122.HK,2,0,0,2,0,0,4,50.00%,
1123.HK,3,0,0,0,0,0,3,100.00%,
1129.HK,1,0,0,2,5,0,8,12.50%,
1130.HK,2,0,0,1,3,0,6,33.33%,
1132.HK,3,0,0,0,2,1,6,50.00%,
1134.HK,0,0,0,0,1,0,1,0.00%,
1137.HK,1,0,0,2,4,0,7,14.29%,
1141.HK,2,0,1,1,3,2,9,33.33%,
1143.HK,1,0,0,0,2,0,3,33.33%,
1145.HK,1,0,1,0,2,0,4,50.00%,
1146.HK,0,0,0,0,0,1,1,0.00%,
1148.HK,1,0,0,0,2,1,4,25.00%,
1150.HK,1,0,0,0,1,2,4,25.00%,
1152.HK,1,0,1,1,2,0,5,40.00%,
1153.HK,0,0,0,0,1,0,1,0.00%,
1159.HK,2,1,0,1,2,1,7,42.86%,
1161.HK,0,0,1,0,0,0,1,100.00%,
1162.HK,1,0,0,0,0,0,1,100.00%,
1163.HK,0,2,0,0,0,0,2,100.00%,
1165.HK,0,0,0,0,3,0,3,0.00%,
1166.HK,0,0,0,0,3,0,3,0.00%,
1170.HK,2,0,0,0,1,0,3,66.67%,
1172.HK,1,0,0,0,2,3,6,16.67%,
1173.HK,1,1,0,0,0,0,2,100.00%,
1180.HK,1,0,0,0,3,0,4,25.00%,
1181.HK,0,1,1,0,0,0,2,100.00%,
1182.HK,2,0,0,0,1,3,6,33.33%,
1183.HK,0,0,0,0,3,1,4,0.00%,
1185.HK,1,0,0,2,0,1,4,25.00%,
1188.HK,2,0,1,0,0,0,3,100.00%,
1189.HK,0,0,1,0,1,0,2,50.00%,
1195.HK,1,0,0,0,3,1,5,20.00%,
1198.HK,3,0,0,0,2,0,5,60.00%,
1200.HK,0,2,0,0,1,0,3,66.67%,
1201.HK,1,0,0,0,4,1,6,16.67%,
1202.HK,0,0,1,1,2,0,4,25.00%,
1203.HK,0,0,1,0,2,1,4,25.00%,
1215.HK,1,0,0,0,3,2,6,16.67%,
1220.HK,1,0,0,1,3,1,6,16.67%,
1221.HK,0,0,0,1,1,0,2,0.00%,
1222.HK,0,0,0,1,2,0,3,0.00%,
1225.HK,5,1,1,0,1,0,8,87.50%,
1226.HK,0,0,0,0,2,1,3,0.00%,
1229.HK,2,0,0,0,4,1,7,28.57%,
1231.HK,1,0,0,0,0,2,3,33.33%,
1235.HK,1,0,0,0,1,1,3,33.33%,
1237.HK,0,0,1,0,0,1,2,50.00%,
1239.HK,0,1,0,0,2,1,4,25.00%,
1240.HK,1,1,0,0,2,0,4,50.00%,
1241.HK,0,1,3,0,3,2,9,44.44%,
1245.HK,0,0,0,0,1,1,2,0.00%,
1247.HK,0,1,0,0,1,0,2,50.00%,
1251.HK,0,0,0,1,3,0,4,0.00%,
1252.HK,0,0,0,0,1,0,1,0.00%,
1253.HK,1,0,0,0,0,1,2,50.00%,
1259.HK,0,0,0,0,0,2,2,0.00%,
1260.HK,0,0,0,0,1,0,1,0.00%,
1262.HK,2,0,0,1,1,0,4,50.00%,
1265.HK,1,0,1,0,3,0,5,40.00%,
1269.HK,3,0,0,1,4,0,8,37.50%,
1272.HK,0,0,0,0,0,1,1,0.00%,
1273.HK,0,0,0,0,0,2,2,0.00%,
1282.HK,0,0,0,0,4,0,4,0.00%,
1283.HK,2,0,0,0,0,0,2,100.00%,
1285.HK,1,0,0,0,2,0,3,33.33%,
1290.HK,0,0,0,1,2,1,4,0.00%,
1292.HK,2,0,0,0,2,0,4,50.00%,
1293.HK,0,0,0,0,2,1,3,0.00%,
1298.HK,0,0,0,0,2,0,2,0.00%,
1301.HK,0,0,0,1,0,0,1,0.00%,
1312.HK,0,0,0,2,1,0,3,0.00%,
1314.HK,0,0,0,1,2,0,3,0.00%,
1315.HK,1,0,0,3,0,2,6,16.67%,
1317.HK,2,0,0,0,1,0,3,66.67%,
1319.HK,0,1,0,0,0,0,1,100.00%,
1323.HK,3,0,0,0,1,0,4,75.00%,
1326.HK,0,1,0,1,2,1,5,20.00%,
1327.HK,0,0,0,0,1,0,1,0.00%,
1328.HK,1,0,0,0,2,0,3,33.33%,
1332.HK,0,0,0,0,3,3,6,0.00%,
1334.HK,0,0,0,0,1,0,1,0.00%,
1335.HK,0,0,0,0,2,3,5,0.00%,
1338.HK,1,0,0,0,0,0,1,100.00%,
1340.HK,2,0,1,0,3,1,7,42.86%,
1343.HK,0,1,0,0,1,0,2,50.00%,
1348.HK,0,0,0,0,1,0,1,0.00%,
1349.HK,2,0,0,0,5,0,7,28.57%,
1351.HK,0,0,0,0,0,1,1,0.00%,
1355.HK,1,1,0,0,0,1,3,66.67%,
1362.HK,0,0,0,1,2,0,3,0.00%,
1370.HK,1,0,0,0,2,0,3,33.33%,
1371.HK,1,0,1,2,1,0,5,40.00%,
1372.HK,0,1,0,0,2,1,4,25.00%,
1373.HK,0,1,0,0,1,0,2,50.00%,
1380.HK,0,0,2,0,1,1,4,50.00%,
1388.HK,1,0,0,0,0,0,1,100.00%,
1389.HK,0,1,0,0,1,0,2,50.00%,
1393.HK,1,1,0,0,2,2,6,33.33%,
1395.HK,0,0,0,1,2,0,3,0.00%,
1397.HK,1,0,0,0,0,0,1,100.00%,
1399.HK,0,0,0,2,0,0,2,0.00%,
1400.HK,1,2,1,0,1,0,5,80.00%,
1401.HK,0,0,0,0,0,1,1,0.00%,
1402.HK,0,1,0,0,0,0,1,100.00%,
1406.HK,0,0,0,0,1,0,1,0.00%,
1413.HK,0,0,0,0,1,0,1,0.00%,
1416.HK,0,1,0,0,0,0,1,100.00%,
1418.HK,1,1,0,0,0,1,3,66.67%,
1419.HK,1,0,1,0,0,0,2,100.00%,
1420.HK,0,0,0,0,1,1,2,0.00%,
1421.HK,0,0,0,0,1,1,2,0.00%,
1427.HK,2,0,0,0,0,0,2,100.00%,
1429.HK,0,0,0,0,1,0,1,0.00%,
1431.HK,1,0,0,1,1,0,3,33.33%,
1442.HK,1,0,0,0,1,0,2,50.00%,
1443.HK,0,0,0,0,2,0,2,0.00%,
1446.HK,1,1,0,0,1,0,3,66.67%,
1447.HK,0,1,0,1,0,1,3,33.33%,
1449.HK,0,0,0,1,0,0,1,0.00%,
1450.HK,0,0,0,0,0,1,1,0.00%,
1451.HK,0,0,0,0,2,0,2,0.00%,
1461.HK,1,0,0,0,2,0,3,33.33%,
1463.HK,0,0,0,0,1,0,1,0.00%,
1466.HK,0,0,0,0,2,1,3,0.00%,
1468.HK,0,0,0,0,4,0,4,0.00%,
1470.HK,1,0,0,0,2,0,3,33.33%,
1473.HK,0,0,0,0,2,0,2,0.00%,
1480.HK,0,0,0,0,1,0,1,0.00%,
1483.HK,1,1,0,0,1,0,3,66.67%,
1488.HK,0,0,0,0,1,0,1,0.00%,
1495.HK,1,0,0,0,0,0,1,100.00%,
1496.HK,2,0,0,0,1,0,3,66.67%,
1502.HK,0,0,0,0,1,0,1,0.00%,
1518.HK,2,0,0,0,0,0,2,100.00%,
1520.HK,0,1,1,0,2,0,4,50.00%,
1522.HK,0,0,0,0,2,0,2,0.00%,
1525.HK,0,0,0,1,1,0,2,0.00%,
1526.HK,0,0,0,1,2,0,3,0.00%,
1527.HK,0,0,0,1,2,0,3,0.00%,
1529.HK,2,1,0,0,0,1,4,75.00%,
1532.HK,0,0,0,0,1,0,1,0.00%,
1536.HK,1,0,0,0,1,1,3,33.33%,
1538.HK,0,1,0,1,1,0,3,33.33%,
1539.HK,0,1,0,0,3,0,4,25.00%,
1542.HK,0,0,0,0,1,0,1,0.00%,
1543.HK,0,0,0,0,1,0,1,0.00%,
1545.HK,0,1,0,0,1,1,3,33.33%,
1549.HK,1,0,0,1,2,0,4,25.00%,
1555.HK,0,0,0,0,1,3,4,0.00%,
1556.HK,1,0,0,1,0,0,2,50.00%,
1557.HK,0,0,0,0,1,0,1,0.00%,
1559.HK,0,0,0,0,1,1,2,0.00%,
1561.HK,0,0,1,0,2,0,3,33.33%,
1563.HK,0,0,0,0,2,0,2,0.00%,
1565.HK,0,0,0,1,0,0,1,0.00%,
1569.HK,0,0,0,0,1,0,1,0.00%,
1572.HK,0,1,0,0,2,0,3,33.33%,
1575.HK,0,1,0,0,2,0,3,33.33%,
1580.HK,1,0,0,1,0,0,2,50.00%,
1581.HK,0,0,0,0,1,0,1,0.00%,
1583.HK,0,0,0,0,0,1,1,0.00%,
1588.HK,1,1,0,0,1,0,3,66.67%,
1593.HK,0,1,0,0,1,0,2,50.00%,
1596.HK,1,0,0,0,1,0,2,50.00%,
1597.HK,0,0,0,0,1,0,1,0.00%,
1598.HK,0,0,0,0,1,0,1,0.00%,
1599.HK,0,0,0,0,3,0,3,0.00%,
1601.HK,0,0,1,0,0,0,1,100.00%,
1608.HK,0,1,0,0,1,0,2,50.00%,
1612.HK,0,0,2,0,0,0,2,100.00%,
1613.HK,0,0,0,0,2,0,2,0.00%,
1616.HK,0,0,0,0,0,1,1,0.00%,
1617.HK,1,0,0,0,5,0,6,16.67%,
1620.HK,1,0,0,0,0,0,1,100.00%,
1621.HK,1,0,0,1,0,1,3,33.33%,
1623.HK,0,0,0,0,2,0,2,0.00%,
1629.HK,0,0,0,0,1,0,1,0.00%,
1631.HK,1,0,0,1,0,0,2,50.00%,
1643.HK,0,0,1,0,0,0,1,100.00%,
1645.HK,1,1,0,2,0,1,5,40.00%,
1652.HK,1,0,1,0,0,0,2,100.00%,
1653.HK,1,0,0,0,0,0,1,100.00%,
1655.HK,0,0,0,1,0,0,1,0.00%,
1661.HK,0,0,0,0,2,0,2,0.00%,
1662.HK,0,0,0,0,1,0,1,0.00%,
1669.HK,0,0,0,0,1,0,1,0.00%,
1671.HK,1,0,0,0,2,0,3,33.33%,
1673.HK,2,0,0,0,3,0,5,40.00%,
1676.HK,0,0,0,0,1,0,1,0.00%,
1679.HK,0,0,0,0,0,1,1,0.00%,
1680.HK,0,0,0,0,0,2,2,0.00%,
1682.HK,0,0,0,0,3,0,3,0.00%,
1689.HK,1,1,0,0,2,0,4,50.00%,
1692.HK,0,0,0,1,0,0,1,0.00%,
1695.HK,0,0,0,0,0,1,1,0.00%,
1697.HK,0,0,1,0,2,0,3,33.33%,
1701.HK,0,0,0,0,0,1,1,0.00%,
1703.HK,0,0,0,2,1,1,4,0.00%,
1707.HK,0,0,0,0,1,1,2,0.00%,
1708.HK,0,1,0,0,1,1,3,33.33%,
1710.HK,0,0,0,0,1,0,1,0.00%,
1711.HK,0,0,0,1,2,1,4,0.00%,
1712.HK,1,0,0,0,0,1,2,50.00%,
1713.HK,0,0,0,0,1,0,1,0.00%,
1715.HK,0,0,0,0,2,0,2,0.00%,
1716.HK,0,0,0,0,1,1,2,0.00%,
1718.HK,0,1,0,1,0,1,3,33.33%,
1719.HK,0,1,0,0,4,0,5,20.00%,
1720.HK,0,0,1,0,0,0,1,100.00%,
1721.HK,0,1,0,0,0,0,1,100.00%,
1723.HK,0,0,0,0,1,0,1,0.00%,
1725.HK,0,0,1,0,0,3,4,25.00%,
1728.HK,1,0,0,2,4,1,8,12.50%,
1731.HK,0,1,0,0,0,1,2,50.00%,
1732.HK,0,0,0,0,1,0,1,0.00%,
1736.HK,0,0,1,0,2,0,3,33.33%,
1737.HK,0,0,1,0,1,0,2,50.00%,
1738.HK,1,0,0,1,2,1,5,20.00%,
1739.HK,0,0,0,0,2,0,2,0.00%,
1740.HK,0,0,2,0,0,0,2,100.00%,
1745.HK,0,0,0,0,0,1,1,0.00%,
1746.HK,0,0,0,0,0,1,1,0.00%,
1748.HK,0,0,0,0,0,1,1,0.00%,
1752.HK,0,0,0,1,1,0,2,0.00%,
1753.HK,0,0,0,0,2,0,2,0.00%,
1757.HK,1,0,0,0,0,0,1,100.00%,
1758.HK,0,0,0,0,1,3,4,0.00%,
1760.HK,2,1,0,0,0,1,4,75.00%,
1762.HK,0,0,1,0,0,0,1,100.00%,
1763.HK,1,0,0,0,0,1,2,50.00%,
1769.HK,0,0,0,0,2,0,2,0.00%,
1771.HK,0,0,0,1,0,0,1,0.00%,
1786.HK,0,0,0,0,2,0,2,0.00%,
1792.HK,0,0,0,0,0,1,1,0.00%,
1795.HK,0,0,1,0,0,0,1,100.00%,
1803.HK,0,1,0,1,1,1,4,25.00%,
1808.HK,1,1,0,0,2,0,4,50.00%,
1812.HK,4,0,0,1,7,0,12,33.33%,
1817.HK,1,0,0,1,0,0,2,50.00%,
1822.HK,0,0,0,0,2,0,2,0.00%,
1823.HK,0,0,0,0,0,1,1,0.00%,
1825.HK,0,0,0,0,0,1,1,0.00%,
1826.HK,0,0,0,0,1,1,2,0.00%,
1827.HK,1,0,0,0,1,0,2,50.00%,
1830.HK,0,0,0,0,1,0,1,0.00%,
1831.HK,1,0,0,0,2,1,4,25.00%,
1832.HK,0,0,0,0,0,1,1,0.00%,
1842.HK,0,0,1,1,2,0,4,25.00%,
1845.HK,0,0,0,0,0,1,1,0.00%,
1846.HK,0,0,0,0,1,0,1,0.00%,
1847.HK,0,0,0,0,1,0,1,0.00%,
1849.HK,0,0,0,0,1,0,1,0.00%,
1851.HK,0,0,0,0,1,2,3,0.00%,
1854.HK,0,0,0,1,2,0,3,0.00%,
1856.HK,1,0,0,0,0,0,1,100.00%,
1858.HK,1,0,0,1,2,2,6,16.67%,
1861.HK,0,0,0,0,0,1,1,0.00%,
1865.HK,1,0,0,0,0,0,1,100.00%,
1868.HK,2,1,1,1,1,1,7,57.14%,
1869.HK,1,0,0,1,1,0,3,33.33%,
1871.HK,0,1,0,0,2,0,3,33.33%,
1875.HK,0,0,0,0,0,1,1,0.00%,
1878.HK,1,0,1,0,4,1,7,28.57%,
1884.HK,1,0,0,1,0,1,3,33.33%,
1889.HK,0,0,0,0,1,0,1,0.00%,
1891.HK,1,0,0,0,0,1,2,50.00%,
1894.HK,0,0,0,0,1,0,1,0.00%,
1900.HK,3,0,0,1,1,0,5,60.00%,
1906.HK,1,1,0,0,0,1,3,66.67%,
1912.HK,0,0,0,0,0,1,1,0.00%,
1915.HK,0,0,0,0,0,1,1,0.00%,
1917.HK,0,0,0,0,3,1,4,0.00%,
1922.HK,0,0,0,1,0,0,1,0.00%,
1925.HK,0,0,0,0,0,1,1,0.00%,
1927.HK,1,0,0,0,1,1,3,33.33%,
1930.HK,0,0,0,0,0,1,1,0.00%,
1933.HK,0,0,0,1,0,0,1,0.00%,
1937.HK,0,0,0,1,0,1,2,0.00%,
1938.HK,1,0,0,0,2,0,3,33.33%,
1941.HK,0,0,0,0,3,0,3,0.00%,
1942.HK,1,0,0,0,1,0,2,50.00%,
1949.HK,1,0,0,0,1,1,3,33.33%,
1955.HK,1,0,0,0,1,0,2,50.00%,
1959.HK,0,0,0,0,2,0,2,0.00%,
1960.HK,0,0,0,0,0,1,1,0.00%,
1961.HK,0,0,0,0,0,2,2,0.00%,
1968.HK,0,0,0,0,1,0,1,0.00%,
1971.HK,0,0,0,0,0,1,1,0.00%,
1975.HK,0,0,0,0,0,1,1,0.00%,
1980.HK,1,1,1,0,4,0,7,42.86%,
1983.HK,0,0,0,0,0,2,2,0.00%,
1985.HK,0,0,0,0,1,0,1,0.00%,
1986.HK,1,0,0,0,1,0,2,50.00%,
1987.HK,0,0,0,0,1,0,1,0.00%,
1991.HK,0,0,1,0,3,1,5,20.00%,
1993.HK,0,0,0,0,1,0,1,0.00%,
2000.HK,2,1,0,1,1,0,5,60.00%,
2002.HK,3,0,0,0,2,1,6,50.00%,
2008.HK,2,2,0,0,2,0,6,66.67%,
2009.HK,1,0,0,1,2,0,4,25.00%,
2012.HK,1,0,0,1,1,2,5,20.00%,
2022.HK,0,0,0,0,1,0,1,0.00%,
2023.HK,1,0,0,0,4,0,5,20.00%,
2028.HK,1,0,0,0,1,0,2,50.00%,
2031.HK,0,0,0,0,1,1,2,0.00%,
2033.HK,0,0,0,0,1,1,2,0.00%,
2051.HK,0,0,0,0,3,0,3,0.00%,
2060.HK,0,0,0,0,1,0,1,0.00%,
2078.HK,0,0,0,0,1,0,1,0.00%,
2086.HK,0,0,0,0,2,0,2,0.00%,
2098.HK,3,0,1,0,2,1,7,57.14%,
2100.HK,0,0,0,0,4,0,4,0.00%,
2101.HK,0,0,0,0,2,0,2,0.00%,
2102.HK,0,0,0,0,0,1,1,0.00%,
2112.HK,1,0,0,0,1,2,4,25.00%,
2116.HK,0,0,0,1,0,0,1,0.00%,
2119.HK,0,0,0,0,0,1,1,0.00%,
2120.HK,1,0,1,0,0,2,4,50.00%,
2125.HK,0,0,0,0,1,0,1,0.00%,
2127.HK,0,0,0,0,1,0,1,0.00%,
2130.HK,1,0,0,0,0,0,1,100.00%,
2131.HK,0,1,0,1,0,0,2,50.00%,
2135.HK,0,0,0,0,1,0,1,0.00%,
2136.HK,1,0,0,0,0,0,1,100.00%,
2137.HK,0,0,0,0,1,1,2,0.00%,
2138.HK,2,0,0,0,0,0,2,100.00%,
2150.HK,0,0,0,0,1,0,1,0.00%,
2159.HK,0,0,1,0,0,0,1,100.00%,
2163.HK,0,0,0,0,2,1,3,0.00%,
2166.HK,1,0,0,0,1,0,2,50.00%,
2170.HK,1,0,0,0,0,0,1,100.00%,
2176.HK,1,1,0,0,1,1,4,50.00%,
2177.HK,0,0,0,0,1,0,1,0.00%,
2178.HK,1,0,0,0,1,1,3,33.33%,
2180.HK,0,0,0,0,0,1,1,0.00%,
2182.HK,2,0,0,0,1,0,3,66.67%,
2185.HK,0,0,1,0,1,0,2,50.00%,
2188.HK,0,1,0,1,0,0,2,50.00%,
2203.HK,0,1,0,0,2,3,6,16.67%,
2211.HK,0,0,1,0,1,0,2,50.00%,
2212.HK,1,0,0,0,3,0,4,25.00%,
2216.HK,0,0,0,0,1,0,1,0.00%,
2218.HK,1,0,0,2,3,0,6,16.67%,
2219.HK,0,0,0,0,1,0,1,0.00%,
2222.HK,0,0,1,0,4,2,7,14.29%,
2223.HK,1,0,0,1,0,0,2,50.00%,
2226.HK,2,0,0,0,1,0,3,66.67%,
2236.HK,1,0,0,0,0,0,1,100.00%,
2237.HK,0,0,0,0,1,0,1,0.00%,
2239.HK,0,1,0,0,0,0,1,100.00%,
2246.HK,0,0,0,0,1,1,2,0.00%,
2250.HK,0,0,0,0,2,0,2,0.00%,
2257.HK,0,0,0,0,2,0,2,0.00%,
2260.HK,1,0,0,0,0,0,1,100.00%,
2263.HK,0,0,0,0,1,0,1,0.00%,
2280.HK,1,0,0,2,2,1,6,16.67%,
2281.HK,0,1,0,0,0,0,1,100.00%,
2293.HK,1,0,0,0,0,0,1,100.00%,
2297.HK,0,0,1,0,0,0,1,100.00%,
2306.HK,0,0,0,0,1,0,1,0.00%,
2307.HK,0,0,0,0,2,0,2,0.00%,
2309.HK,0,0,0,0,0,1,1,0.00%,
2312.HK,0,0,0,0,3,1,4,0.00%,
2317.HK,0,0,0,1,1,0,2,0.00%,
2320.HK,1,0,0,0,1,0,2,50.00%,
2321.HK,0,0,0,0,1,1,2,0.00%,
2322.HK,1,0,1,0,0,3,5,40.00%,
2323.HK,1,0,0,1,1,0,3,33.33%,
2324.HK,1,0,0,0,0,0,1,100.00%,
2326.HK,0,0,0,1,2,0,3,0.00%,
2327.HK,1,1,0,1,3,1,7,28.57%,
2336.HK,0,0,1,0,2,0,3,33.33%,
2339.HK,1,0,1,0,3,1,6,33.33%,
2348.HK,1,0,1,0,3,1,6,33.33%,
2349.HK,2,0,1,2,2,0,7,42.86%,
2350.HK,0,0,0,0,1,0,1,0.00%,
2358.HK,0,0,0,1,2,1,4,0.00%,
2363.HK,0,0,0,0,1,0,1,0.00%,
2369.HK,0,1,0,1,0,0,2,50.00%,
2371.HK,0,0,1,0,2,0,3,33.33%,
2372.HK,0,0,0,0,1,0,1,0.00%,
2377.HK,3,0,0,0,0,0,3,100.00%,
2381.HK,0,0,0,0,1,0,1,0.00%,
2383.HK,0,1,0,2,3,1,7,14.29%,
2392.HK,0,0,0,0,0,1,1,0.00%,
2399.HK,0,1,0,0,1,0,2,50.00%,
2405.HK,0,0,0,2,0,0,2,0.00%,
2407.HK,0,0,0,0,1,0,1,0.00%,
2416.HK,0,0,0,0,1,1,2,0.00%,
2425.HK,0,0,0,0,1,1,2,0.00%,
2427.HK,0,0,0,0,1,0,1,0.00%,
2440.HK,0,0,0,0,1,0,1,0.00%,
2442.HK,0,0,0,0,0,1,1,0.00%,
2450.HK,0,0,0,0,0,1,1,0.00%,
2457.HK,1,0,1,0,0,0,2,100.00%,
2458.HK,0,0,0,0,0,1,1,0.00%,
2483.HK,0,1,0,0,0,0,1,100.00%,
2488.HK,1,1,1,0,6,0,9,33.33%,
2495.HK,0,0,0,0,1,0,1,0.00%,
2496.HK,0,0,0,0,0,1,1,0.00%,
2500.HK,2,0,1,0,0,0,3,100.00%,
2502.HK,0,0,0,0,1,0,1,0.00%,
2505.HK,0,0,1,0,0,0,1,100.00%,
2512.HK,1,0,0,0,0,0,1,100.00%,
2528.HK,0,0,0,1,1,0,2,0.00%,
2530.HK,0,0,0,0,1,0,1,0.00%,
2545.HK,0,1,0,0,0,0,1,100.00%,
2593.HK,0,0,0,0,1,0,1,0.00%,
2623.HK,1,0,0,0,0,1,2,50.00%,
2722.HK,0,0,0,1,1,0,2,0.00%,
2728.HK,1,0,0,0,2,0,3,33.33%,
2738.HK,0,0,0,0,0,1,1,0.00%,
2779.HK,1,1,0,0,0,0,2,100.00%,
2878.HK,3,0,0,0,1,0,4,75.00%,
2882.HK,0,0,0,1,4,0,5,0.00%,
2886.HK,1,0,0,1,0,0,2,50.00%,
3300.HK,1,0,0,0,2,0,3,33.33%,
3303.HK,1,0,0,1,1,1,4,25.00%,
3313.HK,0,0,0,0,4,0,4,0.00%,
3318.HK,1,0,0,2,2,0,5,20.00%,
3322.HK,2,0,0,0,0,0,2,100.00%,
3326.HK,0,0,0,0,1,1,2,0.00%,
3332.HK,0,0,0,1,1,0,2,0.00%,
3363.HK,2,0,0,0,0,1,3,66.67%,
3368.HK,4,0,0,0,3,1,8,50.00%,
3389.HK,3,0,0,3,3,0,9,33.33%,
3390.HK,0,0,0,0,1,0,1,0.00%,
3395.HK,0,0,0,1,0,0,1,0.00%,
3399.HK,0,0,0,1,0,1,2,0.00%,
3601.HK,1,0,0,0,0,0,1,100.00%,
3626.HK,0,0,0,0,0,2,2,0.00%,
3638.HK,1,0,0,0,2,0,3,33.33%,
3639.HK,0,1,0,0,0,0,1,100.00%,
3666.HK,0,0,0,0,1,0,1,0.00%,
3680.HK,0,0,0,0,1,0,1,0.00%,
3683.HK,0,0,0,1,4,0,5,0.00%,
3768.HK,0,0,0,0,1,0,1,0.00%,
3773.HK,2,1,0,0,0,1,4,75.00%,
3778.HK,0,0,0,0,1,0,1,0.00%,
3816.HK,0,0,1,1,0,0,2,50.00%,
3828.HK,0,1,1,1,1,0,4,50.00%,
3836.HK,0,0,0,0,3,0,3,0.00%,
3838.HK,3,0,0,0,1,2,6,50.00%,
3882.HK,0,0,1,0,0,0,1,100.00%,
3889.HK,1,0,1,0,1,1,4,50.00%,
3893.HK,0,0,0,0,1,0,1,0.00%,
3919.HK,2,0,1,0,0,0,3,100.00%,
3989.HK,1,4,0,1,1,0,7,71.43%,
3991.HK,1,0,0,0,1,0,2,50.00%,
3997.HK,0,0,1,0,0,1,2,50.00%,
3999.HK,0,0,0,1,1,0,2,0.00%,
6033.HK,0,0,0,0,3,0,3,0.00%,
6083.HK,0,0,0,0,1,0,1,0.00%,
6100.HK,1,0,0,0,2,0,3,33.33%,
6119.HK,0,0,0,0,1,0,1,0.00%,
6123.HK,0,1,0,1,2,0,4,25.00%,
6133.HK,0,0,0,0,1,1,2,0.00%,
6136.HK,0,1,0,0,1,0,2,50.00%,
6182.HK,1,0,0,0,0,0,1,100.00%,
6193.HK,0,0,1,0,0,1,2,50.00%,
6609.HK,1,0,0,0,1,0,2,50.00%,
6633.HK,1,0,0,0,0,0,1,100.00%,
6661.HK,0,1,0,0,0,0,1,100.00%,
6663.HK,0,1,0,0,0,0,1,100.00%,
6698.HK,0,0,0,2,1,1,4,0.00%,
6812.HK,1,0,0,0,1,0,2,50.00%,
6820.HK,0,0,0,0,1,0,1,0.00%,
6826.HK,3,0,0,0,0,0,3,100.00%,
6828.HK,0,0,0,1,1,1,3,0.00%,
6830.HK,0,0,0,0,2,0,2,0.00%,
6838.HK,1,0,0,0,0,0,1,100.00%,
6839.HK,0,0,0,0,2,1,3,0.00%,
6858.HK,0,0,0,0,1,0,1,0.00%,
6860.HK,1,0,0,0,1,1,3,33.33%,
6878.HK,0,0,0,0,0,1,1,0.00%,
6885.HK,0,0,1,0,0,2,3,33.33%,
6893.HK,0,1,0,0,0,1,2,50.00%,
6898.HK,1,1,0,0,0,0,2,100.00%,
6899.HK,1,0,0,0,0,0,1,100.00%,
6909.HK,0,0,0,0,1,0,1,0.00%,
6911.HK,0,0,0,0,0,1,1,0.00%,
6918.HK,1,0,0,0,1,1,3,33.33%,
6919.HK,0,0,0,0,1,0,1,0.00%,
6928.HK,1,0,0,0,2,0,3,33.33%,
6933.HK,0,0,0,0,0,1,1,0.00%,
6966.HK,2,0,0,0,0,0,2,100.00%,
6988.HK,1,0,0,0,0,0,1,100.00%,
8005.HK,1,0,2,1,0,1,5,60.00%,
8006.HK,0,0,0,0,2,0,2,0.00%,
8007.HK,2,0,0,0,0,3,5,40.00%,
8017.HK,2,0,0,0,1,0,3,66.67%,
8020.HK,0,1,0,0,0,1,2,50.00%,
8026.HK,1,0,0,1,1,0,3,33.33%,
8028.HK,1,0,2,0,2,1,6,50.00%,
8029.HK,3,0,0,0,0,0,3,100.00%,
8031.HK,0,0,0,0,1,0,1,0.00%,
8033.HK,0,1,0,0,1,0,2,50.00%,
8035.HK,0,0,0,0,1,0,1,0.00%,
8036.HK,0,0,0,0,1,0,1,0.00%,
8041.HK,0,0,0,0,2,0,2,0.00%,
8043.HK,0,0,0,0,1,0,1,0.00%,
8047.HK,0,0,0,1,3,0,4,0.00%,
8048.HK,0,0,0,0,2,0,2,0.00%,
8050.HK,0,0,0,0,3,1,4,0.00%,
8051.HK,0,0,0,0,1,1,2,0.00%,
8056.HK,1,0,0,0,0,0,1,100.00%,
8060.HK,0,1,0,0,0,0,1,100.00%,
8062.HK,0,0,0,0,0,1,1,0.00%,
8063.HK,1,0,0,0,1,0,2,50.00%,
8066.HK,0,0,0,0,1,0,1,0.00%,
8069.HK,0,0,0,0,2,0,2,0.00%,
8071.HK,1,0,0,0,1,1,3,33.33%,
8072.HK,0,0,1,0,0,0,1,100.00%,
8073.HK,0,0,0,0,2,0,2,0.00%,
8076.HK,0,0,0,0,0,1,1,0.00%,
8079.HK,1,0,1,1,4,0,7,28.57%,
8081.HK,1,0,0,2,2,0,5,20.00%,
8082.HK,1,0,0,0,3,1,5,20.00%,
8087.HK,0,0,1,0,1,0,2,50.00%,
8092.HK,1,0,0,1,0,1,3,33.33%,
8095.HK,1,0,1,1,2,0,5,40.00%,
8103.HK,1,0,0,1,2,1,5,20.00%,
8106.HK,0,0,1,0,0,0,1,100.00%,
8111.HK,1,2,0,2,1,1,7,42.86%,
8115.HK,0,0,0,0,1,0,1,0.00%,
8117.HK,0,0,0,0,2,0,2,0.00%,
8118.HK,0,0,0,0,1,1,2,0.00%,
8120.HK,1,0,0,1,3,0,5,20.00%,
8123.HK,0,0,0,0,0,1,1,0.00%,
8126.HK,0,0,0,0,0,1,1,0.00%,
8128.HK,1,0,1,1,2,1,6,33.33%,
8130.HK,0,0,1,1,3,3,8,12.50%,
8132.HK,0,0,1,0,1,1,3,33.33%,
8133.HK,0,0,0,1,1,1,3,0.00%,
8136.HK,0,0,0,0,1,1,2,0.00%,
8139.HK,1,0,1,0,1,1,4,50.00%,
8147.HK,0,0,0,0,2,1,3,0.00%,
8152.HK,0,0,0,0,1,0,1,0.00%,
8156.HK,0,0,2,0,2,2,6,33.33%,
8159.HK,0,0,0,0,1,1,2,0.00%,
8162.HK,0,0,0,0,1,0,1,0.00%,
8168.HK,0,0,0,0,4,1,5,0.00%,
8169.HK,0,0,1,0,0,0,1,100.00%,
8172.HK,0,0,0,0,3,4,7,0.00%,
8178.HK,1,0,2,1,2,1,7,42.86%,
8179.HK,1,0,0,1,4,0,6,16.67%,
8186.HK,0,0,0,1,1,1,3,0.00%,
8189.HK,0,0,0,1,2,0,3,0.00%,
8191.HK,0,0,1,2,4,2,9,11.11%,
8193.HK,0,0,0,0,0,2,2,0.00%,
8196.HK,0,0,0,1,0,1,2,0.00%,
8200.HK,2,1,0,0,3,1,7,42.86%,
8201.HK,1,0,0,0,2,0,3,33.33%,
8203.HK,0,1,0,0,3,1,5,20.00%,
8211.HK,0,0,0,0,2,0,2,0.00%,
8219.HK,0,0,0,0,1,0,1,0.00%,
8222.HK,1,0,0,0,1,0,2,50.00%,
8223.HK,0,1,0,0,0,0,1,100.00%,
8227.HK,1,1,0,0,1,1,4,50.00%,
8241.HK,1,0,0,0,0,0,1,100.00%,
8245.HK,1,0,0,0,3,1,5,20.00%,
8246.HK,0,0,0,0,1,0,1,0.00%,
8250.HK,0,1,0,0,1,1,3,33.33%,
8267.HK,0,1,0,1,0,0,2,50.00%,
8277.HK,0,0,0,0,0,1,1,0.00%,
8280.HK,1,0,0,0,1,0,2,50.00%,
8281.HK,0,0,0,0,2,0,2,0.00%,
8283.HK,1,0,0,0,0,1,2,50.00%,
8285.HK,0,0,0,0,1,0,1,0.00%,
8286.HK,0,0,0,0,0,1,1,0.00%,
8291.HK,1,0,0,0,1,0,2,50.00%,
8292.HK,0,0,0,0,1,0,1,0.00%,
8293.HK,0,0,0,0,1,2,3,0.00%,
8295.HK,0,1,0,0,2,1,4,25.00%,
8296.HK,1,0,1,2,1,1,6,33.33%,
8300.HK,1,0,0,0,0,0,1,100.00%,
8307.HK,0,0,0,0,1,0,1,0.00%,
8309.HK,1,0,0,2,1,0,4,25.00%,
8310.HK,0,0,0,0,1,0,1,0.00%,
8311.HK,0,1,0,0,3,0,4,25.00%,
8317.HK,0,1,0,0,6,1,8,12.50%,
8326.HK,1,0,0,0,0,0,1,100.00%,
8328.HK,1,0,0,0,3,0,4,25.00%,
8337.HK,1,0,0,0,0,1,2,50.00%,
8340.HK,2,0,0,0,0,0,2,100.00%,
8347.HK,1,1,0,0,0,1,3,66.67%,
8362.HK,0,0,0,0,1,0,1,0.00%,
8365.HK,0,0,0,0,1,0,1,0.00%,
8367.HK,0,0,0,0,2,0,2,0.00%,
8370.HK,1,0,0,0,0,0,1,100.00%,
8385.HK,0,0,0,0,3,2,5,0.00%,
8391.HK,0,0,1,0,0,0,1,100.00%,
8392.HK,0,0,0,0,0,1,1,0.00%,
8395.HK,1,0,0,0,1,2,4,25.00%,
8400.HK,0,1,0,0,0,0,1,100.00%,
8403.HK,0,0,0,0,2,1,3,0.00%,
8406.HK,0,0,0,0,0,1,1,0.00%,
8413.HK,1,0,1,0,0,0,2,100.00%,
8418.HK,0,0,0,0,1,1,2,0.00%,
8425.HK,0,1,0,0,0,0,1,100.00%,
8430.HK,0,0,0,0,1,0,1,0.00%,
8431.HK,0,0,0,0,2,0,2,0.00%,
8436.HK,1,1,0,0,0,0,2,100.00%,
8450.HK,1,0,0,0,2,0,3,33.33%,
8456.HK,1,0,0,0,1,0,2,50.00%,
8462.HK,0,0,0,0,1,1,2,0.00%,
8473.HK,1,0,1,0,2,1,5,40.00%,
8476.HK,0,0,0,0,1,0,1,0.00%,
8482.HK,1,0,0,0,1,1,3,33.33%,
8487.HK,1,0,0,0,3,0,4,25.00%,
8489.HK,0,0,0,0,0,1,1,0.00%,
8490.HK,0,0,0,0,0,3,3,0.00%,
8502.HK,0,0,0,1,0,0,1,0.00%,
8512.HK,2,0,0,0,0,0,2,100.00%,
8513.HK,0,2,0,1,2,0,5,40.00%,
8521.HK,0,0,0,0,1,1,2,0.00%,
8525.HK,0,0,0,0,1,0,1,0.00%,
8529.HK,0,0,0,0,1,1,2,0.00%,
8536.HK,0,0,0,0,1,2,3,0.00%,
8545.HK,1,0,0,0,4,0,5,20.00%,
8547.HK,0,0,1,0,4,0,5,20.00%,
8603.HK,0,0,0,0,0,1,1,0.00%,
8606.HK,1,0,0,0,0,0,1,100.00%,
8612.HK,1,0,0,0,4,0,5,20.00%,
8627.HK,0,0,0,0,1,0,1,0.00%,
8631.HK,0,0,1,0,1,1,3,33.33%,
8637.HK,0,0,0,0,1,0,1,0.00%,
8645.HK,0,1,1,0,0,0,2,100.00%,
8646.HK,0,2,1,0,2,2,7,42.86%,
8657.HK,0,0,1,0,1,0,2,50.00%,
8659.HK,2,0,0,0,1,0,3,66.67%,
9689.HK,0,0,0,0,0,1,1,0.00%,
9908.HK,0,0,0,0,1,0,1,0.00%,
9918.HK,0,0,1,0,1,0,2,50.00%,
9955.HK,0,0,0,0,1,0,1,0.00%,
9963.HK,0,0,0,1,1,0,2,0.00%,
9990.HK,0,0,0,1,0,0,1,0.00%,
9991.HK,0,0,0,0,1,0,1,0.00%,
,720,262,201,345,1660,613,3801,31.12%,-169
